
[tile]
unknowntile=未知
watertile=水
emptytile=空白地面
grasstile=草地面
sandtile=沙子地面
swampgrasstile=沼泽草地面
mudtile=淤泥地面
dirttile=泥土地面
rocktile=岩石地面
dungeonfloor=地牢地板
farmland=农田地面
woodfloor=木地板
pinefloor=松木地板
palmfloor=棕榈地板
woodpathtile=木头路
deadwoodfloor=枯木地板
stonefloor=石头地板
stonebrickfloor=岩石地板
stonetiledfloor=石头地板
stonepathtile=石头路
sandstonetile=沙石地面
sandstonefloor=沙石地板
sandstonebrickfloor=砂岩砖地板
sandstonepathtile=沙石地板
swamprocktile=沼泽岩石路
swampstonefloor=沼泽岩石地板
swampstonebrickfloor=沼泽岩石砖地板
swampstonepathtile=沼泽岩石地板
snowrocktile=雪地岩石地板
lavatile=岩浆
snowtile=雪
icetile=冰
snowstonefloor=雪石地板
snowstonebrickfloor=雪石砖地板
snowstonepathtile=雪石路
graveltile=砾石
sandbrick=沙砖
deeprocktile=深岩
deepstonefloor=深石地板
deepstonebrickfloor=深石砖地板
deepstonetiledfloor=深层岩地板
deepsnowrocktile=深层雪地岩地面
deepsnowstonefloor=深层雪地石地板
deepsnowstonebrickfloor=深层雪地石砖地板
deepswamprocktile=深层沼泽岩
deepswampstonefloor=深层沼泽岩地板
deepswampstonebrickfloor=深层沼泽石砖地板
deepicetile=深层坚冰地面
sandgraveltile=砂砾地面
spidernesttile=蜘蛛巢穴地面
cryptash=墓穴空气灰烬地面
deepsandstonetile=深层沙石地面
strawtile=稻草地面
liquidslimetile=史莱姆液体
slimerocktile=史莱姆岩石地面
cryptpath=墓穴地面
spidercobbletile=蜘蛛圆石地面
spidercastlefloor=蛛魔城堡地面
spidercastlecarpet=蛛魔城堡地毯

[object]
unknownobject=未知物体
air=空气

// Trees/big flora
oaktree=橡树
oaksapling=橡树树苗
sprucetree=云杉树
sprucesapling=云杉树苗
pinetree=松树
pinesapling=松树树苗
palmtree=棕榈树
palmsapling=棕榈树苗
willowtree=柳树
willowsapling=柳树树苗
cactus=仙人掌
cactussapling=仙人掌苗
deadwoodtree=枯树
appletree=苹果树
applesapling=苹果树苗
lemontree=柠檬树
lemonsapling=柠檬树苗
coconuttree=椰子树
coconutsapling=椰子树苗
bananatree=香蕉树
bananasapling=香蕉树苗
blueberrybush=蓝莓灌木
blueberrysapling=蓝莓灌木苗
blackberrybush=黑莓灌木
blackberrysapling=黑莓灌木苗

// Work stations
workstation=工作站
forge=熔炉
carpentersbench=木工台
ironanvil=铁砧
demonicworkstation=恶魔工作站
alchemytable=炼金工作台
advancedworkstation=高级工作站
fallenworkstation=堕落工作站
fallenalchemytable=堕落炼金工作台

// Walls and doors etc
woodwall=木墙
wooddoor=木门
wooddoorlocked=上锁的木门
pinewall=松木墙
pinedoor=松木门
pinedoorlocked=上锁的松木门
palmwall=棕榈墙
palmdoor=棕榈门
palmdoorlocked=上锁的棕榈门
stonewall=石墙
stonedoor=石门
stonedoorlocked=上锁的石门
sandstonewall=沙石墙
sandstonedoor=沙石门
sandstonedoorlocked=上锁的沙石门
swampstonewall=沼泽岩石墙
swampstonedoor=沼泽岩石门
swampstonedoorlocked=上锁的沼泽岩石门
snowstonewall=雪地岩石墙
snowstonedoor=雪地岩石门
snowstonedoorlocked=上锁的雪地岩石门
icewall=冰墙
icedoor=冰门
icedoorlocked=上锁的冰门
brickwall=砖墙
brickdoor=砖门
brickdoorlocked=上锁的砖门
dungeonwall=地牢墙
dungeondoor=地牢门
dungeondoorlocked=上锁的地牢门
deepstonewall=深层岩石墙
deepstonedoor=深层岩石门
deepstonedoorlocked=上锁的深层岩石门
obsidianwall=黑曜石墙
obsidiandoor=黑曜石门
obsidiandoorlocked=上锁的黑曜石门
deepsnowstonewall=深层雪石墙
deepsnowstonedoor=深层雪石门
deepsnowstonedoorlocked=上锁的深层雪石门
deepswampstonewall=深层沼石墙
deepswampstonedoor=深层沼石门
deepswampstonedoorlocked=上锁的深层沼石门
deepsandstonewall=深层沙石墙
deepsandstonedoor=深层沙石门
deepsandstonedoorlocked=上锁的深层沙石门
cryptwall=墓穴墙
cryptdoor=墓穴门
cryptdoorlocked=上锁的墓穴门
spidercastlewall=蛛魔城堡墙
spidercastledoor=蛛魔城堡门
spidercastledoorlocked=上锁的蛛魔城堡门
woodfence=木栅栏
woodfencegate=木栅栏门
stonefence=石栅栏
stonefencegate=石栅栏门
ironfence=铁栅栏
ironfencegate=铁栅栏门
cryptfence=墓穴栅栏
cryptfencegate=墓穴栅栏门
woodcolumn=木柱
stonecolumn=石柱
snowstonecolumn=雪石柱
swampstonecolumn=沼泽岩石柱
sandstonecolumn=沙石柱
deepstonecolumn=深层岩石柱
obsidiancolumn=黑曜石柱
deepsnowstonecolumn=深层雪石柱
deepswampstonecolumn=深层沼石柱
deepsandstonecolumn=深层沙石柱
cryptcolumn=墓穴柱
spidercastlecolumn=蛛魔城堡柱

// Inventories
storagebox=储物箱
barrel=储物桶
demonchest=恶魔宝箱
coolingbox=冷藏箱
incinerator=焚化炉

// ### Furniture ###
// Lighting
torch=火把
walltorch=壁式火把
ironlamp=铁灯
goldlamp=金灯
firechalice=火焰圣杯
templefirechalice=圣殿火焰圣杯

// Misc
sign=木牌
flowerpot=花盆
itemstand=物品展示台
armorstand=盔甲架
trainingdummy=训练假人
snowmantrainingdummy=雪人
stonecoffin=石棺
cryptcoffin=墓穴棺
gravestone=墓碑
minecarttrack=矿车轨道
traptrack=陷阱轨道

// Furniture types
// Oak
oakchest=橡木箱子
oakdinnertable=橡木餐桌
oakdesk=橡木桌
oakmodulartable=橡木组合桌
oakchair=橡木椅
oakbench=橡木长椅
oakbookshelf=橡木书架
oakcabinet=橡木柜
oakbed=橡木床
oakdresser=橡木梳妆台
oakclock=橡木座钟
oakcandelabra=橡木烛台
oakdisplay=橡木展示台
oakbathtub=橡木浴缸
oaktoilet=橡木马桶

// Spruce
sprucechest=云杉箱子
sprucedinnertable=云杉餐桌
sprucedesk=云杉桌
sprucemodulartable=云杉组合桌
sprucechair=云杉椅
sprucebench=云杉长椅
sprucebookshelf=云杉书架
sprucecabinet=云杉柜
sprucebed=云杉床
sprucedresser=云杉梳妆台
spruceclock=云杉座钟
sprucecandelabra=云杉烛台
sprucedisplay=云杉展示台
sprucebathtub=云杉浴缸
sprucetoilet=云杉马桶

// Pine
pinechest=松木箱子
pinedinnertable=松木餐桌
pinedesk=松木桌
pinemodulartable=松木组合桌
pinechair=松木椅
pinebench=松木长椅
pinebookshelf=松木书架
pinecabinet=松木柜
pinebed=松木床
pinedresser=松木梳妆台
pineclock=松木座钟
pinecandelabra=松木烛台
pinedisplay=松木展示台
pinebathtub=松木浴缸
pinetoilet=松木马桶

// Palm
palmchest=棕榈木箱子
palmdinnertable=棕榈木餐桌
palmdesk=棕榈木桌
palmmodulartable=棕榈木组合桌
palmchair=棕榈木椅
palmbench=棕榈木长椅
palmbookshelf=棕榈木书架
palmcabinet=棕榈木柜
palmbed=棕榈木床
palmdresser=棕榈木梳妆台
palmclock=棕榈木座钟
palmcandelabra=棕榈木烛台
palmdisplay=棕榈木展示台
palmbathtub=棕榈木浴缸
palmtoilet=棕榈木马桶

// Dungeon
dungeonchest=地牢箱子
dungeondinnertable=地牢餐桌
dungeondesk=地牢桌
dungeonmodulartable=地牢组合桌
dungeonchair=地牢椅
dungeonbench=地牢长椅
dungeonbookshelf=地牢书架
dungeoncabinet=地牢柜
dungeonbed=地牢床
dungeondresser=地牢梳妆台
dungeonclock=地牢座钟
dungeoncandelabra=地牢烛台
dungeondisplay=地牢展示台
dungeonbathtub=地牢浴缸
dungeontoilet=地牢马桶
deadwoodchest=枯木箱子
deadwooddinnertable=枯木餐桌
deadwooddesk=枯木桌
deadwoodmodulartable=枯木组合桌
deadwoodchair=枯木椅
deadwoodbench=枯木长椅
deadwoodbookshelf=枯木书架
deadwoodcabinet=枯木柜
deadwoodbed=枯木床
deadwooddresser=枯木梳妆台
deadwoodclock=枯木座钟
deadwoodcandelabra=枯木烛台
deadwoodcandles=枯木蜡烛
deadwooddisplay=枯木展示台
deadwoodbathtub=枯木浴缸
deadwoodtoilet=枯木马桶
spiderthrone=蛛魔王座
spidercastlecandelabra=蛛魔城堡烛台
spidercastlewallcandle=蛛魔城堡壁烛台
spidercastlemodulartable=蛛魔城堡组合桌
spidercastlechair=蛛魔城堡椅
spidercastlebench=蛛魔城堡长椅
spidercastlebookshelf=蛛魔城堡书架
spideritearmorstand=蛛裔盔甲架

// Misc
wooddinnertable=木餐桌
wooddesk=木桌
woodmodulartable=木组合桌
woodchair=木椅
golddinnertable=金餐桌
goldchair=金椅
woodbookshelf=木书架
woodbathtub=木浴缸
woodtoilet=木马桶
apiary=养蜂场
beehive=蜂巢

// Carpets
woolcarpet=羊毛地毯
leathercarpet=皮质地毯
groundslime=史莱姆地毯

// Beds
woodbed=木床

// Logic - traps etc
woodpressureplate=木质压力板
stonepressureplate=石质压力板
snowstonepressureplate=雪岩压力板
swampstonepressureplate=沼泽岩石压力板
sandstonepressureplate=砂岩压力板
dungeonpressureplate=地牢压力板
deepstonepressureplate=深层石材压力板
deepsnowstonepressureplate=深雪石材压力板
deepswampstonepressureplate=深沼石材压力板
rocklever=石质拉杆
ledpanel=LED面板
woodwalltrap=木 <trap>
stonewalltrap=石 <trap>
sandstonewalltrap=沙石 <trap>
swampstonewalltrap=沼泽岩石 <trap>
snowstonewalltrap=雪地岩石 <trap>
icewalltrap=冰 <trap>
deepstonewalltrap=深层岩石 <trap>
obsidianwalltrap=黑曜石 <trap>
dungeonwalltrap=地牢 <trap>
deepsnowstonewalltrap=深层雪地 <trap>
deepswampstonewalltrap=深层沼泽 <trap>
deepsandstonewalltrap=深层沙石 <trap>
spidercastlewalltrap=蛛魔城堡墙 <trap>
arrowtrap=弓箭陷阱
flametrap=火焰陷阱
spiketrap=尖刺陷阱
sawtrap=锯刃陷阱
voidtrap=虚空陷阱
SAME_TRANSLATION:tnt=TNT
fireworkdispenser=烟花发射器

// Food
wheatseed=小麦种子
cornseed=玉米种子
tomatoseed=番茄种子
cabbageseed=卷心菜种子
chilipepperseed=辣椒种子
sugarbeetseed=甜菜种子
eggplantseed=茄子种子
potatoseed=土豆种子
riceseed=水稻种子
carrotseed=胡萝卜种子
onionseed=洋葱种子
pumpkinseed=南瓜种子
strawberryseed=草莓种子
coffeebeans=咖啡豆

// Flowers / Alchemy
sunflowerseed=向日葵种子
wildsunflower=野生向日葵
sunflower=向日葵
firemoneseed=火焰花种子
wildfiremone=野生火焰花
firemone=火焰花
iceblossomseed=寒冰花种子
wildiceblossom=野生寒冰花
iceblossom=寒冰花
mushroom=蘑菇
wildmushroom=野生蘑菇
mushroomflower=成熟蘑菇
caveglowsprout=洞穴辉光萌芽
wildcaveglow=野生洞穴辉光
caveglow=洞穴辉光

// Processing
campfire=营火
cookingpot=烹饪锅
roastingstation=烧烤台
cookingstation=烹饪工作站
compostbin=堆肥桶
grainmill=风车磨坊
cheesepress=压酪机
feedingtrough=喂食盆
singlerock=单个 <rock>
smallsinglerock=单个小 <rock>

rock=岩石
sandstonerock=沙石
swamprock=沼泽岩石
snowrock=雪地岩石
deeprock=深层岩石
deepsnowrock=深层雪地岩石
deepswamprock=深层沼泽岩石
deepsandstonerock=深层沙石
slimerock=史莱姆岩石
spiderrock=蜘蛛岩石

clayrock=粘土岩
obsidianrock=黑曜石

ironore=铁矿石
copperore=铜矿石
goldore=金矿石
frostshardore=冰霜碎片
ivyore=常春藤矿石
quartzore=石英
tungstenore=钨矿石
lifequartzore=生命石英
glacialore=冰川矿石
myceliumore=菌丝矿石
ancientfossilore=远古化石矿石
alchemyshardore=炼金石碎片
slimeum=史莱姆矿石
nightsteelore=夜铁矿石
spideriteore=蛛裔矿石

// Misc
grass=草
swampgrass=沼泽草
cryptgrass=墓穴草
cattail=香蒲
watergrass=水草
snowpile=积雪
cobweb=蜘蛛网
thorns=荆棘
ladderdown=梯子(向下)
ladderup=梯子(向上)
dungeonentrance=地牢入口
trialentrance=试炼入口
trialexit=试炼出口
dungeonexit=地牢出口
deepladderdown=深层梯子(向下)
deepladderup=深层梯子(向上)
templeentrance=圣殿入口
templeexit=圣殿出口
fallenaltar=堕落祭坛
upgradestation=升级工作站
coinstack=金币堆
crate=箱
snowcrate=雪地箱
swampcrate=沼泽箱
vase=花瓶
ancienttotem=远古图腾
templepedestal=神殿基座
settlementflag=营地旗帜
homestone=传送石碑
waystone=路径石碑
travelstone=旅行石碑
bannerstand=旗帜架
musicplayer=音乐播放器
cartographertable=制图师桌子
spideregg=蜘蛛蛋
christmastree=圣诞树
christmaswreath=圣诞花环

[logicgate]
andgate=与门
nandgate=与非门
orgate=或门
norgate=或非门
xorgate=异或门
tflipflopgate=T触发器
srlatchgate=SR锁存器
countergate=计数器
timergate=计时器
buffergate=缓冲器
delaygate=延迟器
sensorgate=传感器
soundgate=声音传感器

[logictooltips]
logicinputs=输入： <value>
logicoutputs=输出： <value>
logicactive=运行中
logicinactive=闲置中
bufferdelay=延迟： <value>
sensorplayeron=检测玩家：开
sensorplayeroff=检测玩家：关
sensorhostileon=检测敌人：开
sensorhostileoff=检测敌人：关
sensorpassiveon=检测被动生物：开
sensorpassiveoff=检测被动生物：关
rsactivate=激活: <value>
rsreset=重置: <value>
tflipflopout1=翻转
tflipflopout2=不翻转
counterinc=增长: <value>
counterdec=减少: <value>
countervalue=值: <value>/<max>
timerticks=滴答刻度: <value>
timercurrent=计时器: <value>
timeractive=运行中
timerinactive=闲置中
soundbass=低音
soundhat=高音
soundkick=底鼓
soundpiano=钢琴
soundsnare=小鼓
soundnone=不发声
soundname=声音名称： <name>
soundsemitone=半音程： <value>

[item]
// General materials
coin=金币
oaklog=橡木
sprucelog=云杉木
pinelog=松木
palmlog=棕榈木
willowlog=柳木
deadwoodlog=枯木
stone=石头
sandstone=沙石
swampstone=沼泽岩石
snowstone=雪地岩石
deepstone=深层岩石
deepsnowstone=深层雪地岩石
deepswampstone=深层沼泽岩石
deepsandstone=深层沙岩
cryptstone=墓穴岩石
spiderstone=蜘蛛岩石
batwing=蝙蝠翅膀
silk=丝绸
wormcarapace=蠕虫甲壳
phantomdust=幻影尘土
honeybee=蜜蜂
queenbee=蜂后
apiaryframe=蜂巢框
wool=羊毛
leather=皮革
clay=粘土
copperore=铜矿石
copperbar=铜锭
ironore=铁矿石
ironbar=铁锭
goldore=金矿石
goldbar=金锭
frostshard=冰霜碎片
ivyore=常春藤矿石
ivybar=常春藤锭
quartz=石英
lifequartz=生命石英
demonicbar=恶魔锭
tungstenore=钨矿石
tungstenbar=钨锭
glacialore=冰川矿石
glacialbar=冰川锭
myceliumore=菌丝矿石
myceliumbar=菌丝锭
ancientfossilore=远古化石矿石
ancientfossilbar=远古化石锭
obsidian=黑曜石
slimeum=史莱姆矿石
nightsteelore=夜铁矿石
nightsteelbar=夜铁锭
spideriteore=蛛裔矿石
spideritebar=蛛裔锭
cavespidergland=洞穴蜘蛛腺体
voidshard=虚空残片
swampsludge=沼泽淤泥
bone=骨头
ectoplasm=流质
slimematter=史莱姆物质
spidervenom=蛛毒
glacialshard=冰川残片
glassbottle=玻璃瓶
book=书本
alchemyshard=炼金石碎片
shadowessence=暗影精华
cryoessence=急冻精华
bioessence=生物精华
primordialessence=原始精华
slimeessence=史莱姆精华
bloodessence=鲜血精华
spideressence=蜘蛛精华
carp=鲤鱼
cod=鳕鱼
herring=鲱鱼
mackerel=马鲛鱼
salmon=鲑鱼
trout=鳟鱼
tuna=金枪鱼
gobfish=戈布鱼
terrorfish=恐惧之鱼
halffish=半鱼
rockfish=岩鱼
furfish=毛皮之鱼
icefish=冰霜之鱼
swampfish=沼泽之鱼
mapfragment=地图碎片
spareboatparts=备用船舶零件
brokencoppertool=损坏的铜器
brokenirontool=损坏的铁器

// Pickaxes
woodpickaxe=木镐
copperpickaxe=铜镐
ironpickaxe=铁镐
goldpickaxe=金镐
frostpickaxe=冰霜镐
demonicpickaxe=恶魔镐
ivypickaxe=常春藤镐
tungstenpickaxe=钨镐
glacialpickaxe=冰川镐
icepickaxe=冰镐
myceliumpickaxe=菌丝镐
ancientfossilpickaxe=古代化石镐

// Axes
woodaxe=木斧
copperaxe=铜斧
ironaxe=铁斧
goldaxe=金斧
frostaxe=冰霜斧
demonicaxe=恶魔斧
ivyaxe=常春藤斧
tungstenaxe=钨斧
glacialaxe=冰川斧
myceliumaxe=菌丝斧
ancientfossilaxe=古代化石斧

// Shovels
woodshovel=木铲
coppershovel=铜铲
ironshovel=铁铲
goldshovel=金铲
frostshovel=冰霜铲
ivyshovel=常春藤铲
demonicshovel=恶魔铲
tungstenshovel=钨铲
glacialshovel=冰川铲
myceliumshovel=菌丝铲
ancientfossilshovel=古代化石铲

// Fishing rods
godrod=神级钓竿
woodfishingrod=木钓竿
ironfishingrod=铁钓竿
overgrownfishingrod=植物钓竿
goldfishingrod=金钓竿
depthscatcher=深水捕集器

// Bait
godbait=神级鱼饵
wormbait=蠕虫鱼饵
swamplarva=沼泽虫鱼饵
anglersbait=渔人鱼饵

// Misc tools
sickle=镰刀
farmingscythe=农用镰刀
wrench=扳手
cutter=切割机
wire=导线
net=网

// Swords
woodsword=木剑
coppersword=铜剑
ironsword=铁剑
goldsword=金剑
frostsword=冰霜剑
nunchucks=双节棍
heavyhammer=沉重之锤
lightninghammer=雷霆之锤
demonicsword=恶魔剑
spiderclaw=蜘蛛之爪
ivysword=常春藤剑
cutlass=海盗弯刀
tungstensword=钨剑
reaperscythe=死神镰刀
sandknife=砂刃
venomslasher=毒液剑
antiquesword=上古剑
bloodclaw=血爪
thecrimsonsky=猩红苍穹
causticexecutioner=腐蚀处刑者
irongreatsword=铁巨剑
frostgreatsword=冰霜巨剑
ivygreatsword=常春藤巨剑
quartzgreatsword=石英巨剑
glacialgreatsword=冰川巨剑
slimegreatsword=史莱姆巨剑

// Spears
woodspear=木矛
copperpitchfork=铜叉
copperspear=铜矛
ironspear=铁矛
goldspear=金矛
frostspear=冰霜矛
demonicspear=恶魔矛
voidspear=虚空矛
ivyspear=常春藤矛
vulturestalon=秃鹫利爪
tungstenspear=钨矛
cryospear=冰矛

// Glaives
goldglaive=金阔剑
frostglaive=冰霜阔剑
quartzglaive=石英阔剑
cryoglaive=急冻阔剑
slimeglaive=史莱姆阔剑

// Bows
woodbow=木弓
copperbow=铜弓
ironbow=铁弓
goldbow=金弓
frostbow=冰霜弓
demonicbow=恶魔弓
ivybow=常春藤弓
vulturesburst=秃鹫神速
tungstenbow=钨弓
glacialbow=冰川弓
bowofdualism=双重弓
antiquebow=远古弓
arachnidwebbow=蛛网弓
goldgreatbow=金巨弓
voidgreatbow=虚空巨弓
ivygreatbow=常春藤巨弓
tungstengreatbow=钨巨弓
myceliumgreatbow=菌丝巨弓
druidsgreatbow=德鲁伊弓
nightpiercer=刺穿黑夜

// Arrows
stonearrow=石箭
firearrow=焰火箭
frostarrow=冰霜箭
poisonarrow=剧毒箭
bouncingarrow=弹跳箭
ironarrow=铁箭
bonearrow=骨箭
spideritearrow=蛛裔箭

// Guns
handgun=手枪
webbedgun=织网枪
sniperrifle=狙击步枪
machinegun=机枪
shotgun=霰弹枪
flintlock=左轮手枪
handcannon=便携加农炮
deathripper=亡者之悼
cryoblaster=冰之爆裂
livingshotty=活体枪
antiquerifle=远古步枪
snowlauncher=雪球发射器

// Bullets
simplebullet=简易子弹
frostbullet=冰霜子弹
bouncingbullet=弹跳子弹
voidbullet=虚空子弹
cannonball=炮弹

// Magic weapons
bloodbolt=鲜血迸发
bloodvolley=血色绽放
froststaff=霜星法杖
voidstaff=虚空法杖
voidmissile=虚空导弹
swamptome=沼泽之典
genielamp=精灵神灯
woodstaff=木法杖
sparkler=火花
venomstaff=毒液法杖
dredgingstaff=淤泥法杖
boulderstaff=巨石法杖
quartzstaff=石英法杖
elderlywand=古老法杖
shadowbolt=暗影导弹
iciclestaff=冰柱法杖
shadowbeam=暗影激光
cryoquake=急冻地震
swampdwellerstaff=沼泽管理权杖
venomshower=毒液法杖
ancientdredgingstaff=远古淤泥法杖
dragonlance=神龙闪
slimestaff=史莱姆法杖
phantompopper=幻影法杖
bloodgrimoire=血之魔典
slimegreatbow=史莱姆巨弓
webweaver=织网者

// Throw weapons
ninjastar=忍者飞镖
icejavelin=冰标枪
woodboomerang=木回旋镖
spiderboomerang=蜘蛛回旋镖
frostboomerang=冰霜回旋镖
voidboomerang=虚空回旋镖
razorbladeboomerang=剃刀回旋镖
tungstenboomerang=钨回旋镖
hook=钩子
ironbomb=铁制炸弹
dynamitestick=炸药
tilebomb=地面炸弹
boxingglovegun=拳击手套枪
glacialboomerang=冰川回旋镖
carapacedagger=甲壳匕首
dragonsrebound=神龙回闪
nightrazorboomerang=暗影回旋镖
snowball=雪球

// Summon weapons
brainonastick=大脑权杖
spiderstaff=蜘蛛权杖
frostpiercer=冰霜穿刺者
magicbranch=魔法枝桠
slimecanister=史莱姆罐
vulturestaff=秃鹫权杖
cryostaff=急冻法杖
phantomcaller=幻影权杖
reaperscall=死神呼唤
swampsgrasp=毒液权杖
skeletonstaff=骷髅权杖
orbofslimes=史莱姆之球
empresscommand=女皇懿旨

// Banners
bannerofspeed=速度旗帜
bannerofdamage=伤害旗帜
bannerofsummonspeed=召唤物速度旗帜
bannerofdefense=防御旗帜

// Misc weapons
forceofwind=狂风之力
blinkscepter=闪光权杖

// Trinkets
ninjasmark=忍者徽章
leatherglove=皮革手套
trackerboot=追踪靴
shinebelt=闪耀腰带
explorersatchel=探险家背包
vampiresgift=吸血鬼的馈赠
leatherdashers=皮飞靴
zephyrcharm=微风护石
zephyrboots=微风靴
woodshield=木盾
hardenedshield=加固木盾
tungstenshield=钨盾
agedchampionshield=冠军徽章
carapaceshield=甲壳盾
demonclaw=恶魔之爪
polarclaw=极地之爪
fins=鱼鳍
fuzzydice=模糊骰子
noblehorseshoe=贵族马掌
luckycape=幸运披风
piratetelescope=海盗望远镜
regenpendant=再生吊坠
mobilitycloak=速度斗篷
travelercloak=旅行斗篷
explorercloak=探索斗篷
mesmertablet=催眠药片
inducingamulet=诱导护身符
lifeline=命悬一线护符
frozensoul=冰冻魂魄
magicfoci=魔法护符
rangefoci=远程护符
meleefoci=近战护符
summonfoci=召唤护符
balancedfoci=平衡护符
ancientfeather=远古之羽
assassinscowl=刺客兜帽
airvessel=空气罐
miningcharm=采矿护符
minersbouquet=矿工花束
calmingminersbouquet=平静矿工花束
cactusshield=仙人掌之盾
siphonshield=虹吸之盾
sparegemstones=备用宝石
spellstone=符咒石
dreamcatcher=捕梦网
nightmaretalisman=梦魇护身符
prophecyslab=预言板
magicmanual=魔法手册
scryingcards=占卜牌
forbiddenspellbook=禁忌咒语书
magicalquiver=魔法箭袋
ammobox=弹药箱
frozenheart=冰冻之心
frozenwave=冰冻之波
spidercharm=蜘蛛之魅
shellofretribution=报复之壳
guardianshell=守护者之壳
bonehilt=骨制手柄
firestone=火焰之石
lifependant=生命吊坠
constructionhammer=建筑锤
telescopicladder=伸缩梯
toolextender=工具扩展器
toolbox=工具箱
itemattractor=物品吸引器
spikedboots=钉靴
spikedbatboots=蝙蝠钉靴
froststone=寒冰之石
frostflame=冰焰之石
balancedfrostfirefoci=平衡冰火护符
calmingrose=平静玫瑰
hysteriatablet=狂暴药片
frenzyorb=狂暴宝珠
scryingmirror=占卜镜
diggingclaw=挖掘之爪
templependant=圣殿吊坠
ancientrelics=远古遗物
gelatincasings=凝胶护套
bloodstonering=血石戒指
claygauntlet=黏土手套
vambrace=臂甲
chainshirt=锁子甲
manica=袖甲
agedchampionscabbard=陈旧冠军剑鞘
challengerspauldron=挑战者的肩甲
clockworkheart=发条心

// Armor
leatherhood=皮兜帽
leathershirt=皮衣
leatherboots=皮靴
clothhat=布帽
clothrobe=布衣
clothboots=布靴
copperhelmet=铜头盔
copperchestplate=铜胸甲
copperboots=铜靴
ironhelmet=铁头盔
ironchestplate=铁胸甲
ironboots=铁靴
goldhelmet=金盔
goldchestplate=金甲
goldboots=金靴
spiderhelmet=蜘蛛头盔
spiderchestplate=蜘蛛胸甲
spiderboots=蜘蛛靴
frosthelmet=冰霜头盔
frosthood=冰霜兜帽
frosthat=冰霜帽
frostchestplate=冰霜胸甲
frostboots=冰霜靴
ninjahood=忍者兜帽
ninjarobe=忍者袍
ninjashoes=忍者鞋
demonichelmet=恶魔头盔
demonicchestplate=恶魔胸甲
demonicboots=恶魔靴
voidmask=虚空面罩
voidhat=虚空帽
voidrobe=虚空袍
voidboots=虚空靴
ivyhelmet=常春藤头盔
ivyhood=常春藤兜帽
ivyhat=常春藤帽
ivycirclet=常春藤头环
ivychestplate=常春藤胸甲
ivyboots=常春藤靴
quartzhelmet=石英头盔
quartzcrown=石英皇冠
quartzchestplate=石英胸甲
quartzboots=石英靴
tungstenhelmet=钨头盔
tungstenchestplate=钨胸甲
tungstenboots=钨靴
shadowhat=暗影帽
shadowhood=暗影兜帽
shadowmantle=暗影斗篷
shadowboots=暗影靴
glacialcirclet=冰川头环
glacialhelmet=冰川头盔
glacialchestplate=冰川胸甲
glacialboots=冰川靴
myceliumhood=菌丝兜帽
myceliumscarf=菌丝围巾
myceliumchestplate=菌丝胸甲
myceliumboots=菌丝靴
widowhelmet=寡妇头盔
widowchestplate=寡妇胸甲
widowboots=寡妇靴
ancientfossilmask=远古化石面具
ancientfossilhelmet=远古化石头盔
ancientfossilchestplate=远古化石胸甲
ancientfossilboots=远古化石靴
slimehat=史莱姆帽
slimehelmet=史莱姆头盔
slimechestplate=史莱姆胸甲
slimeboots=史莱姆靴
nightsteelhelmet=夜钢头盔
nightsteelmask=夜钢面具
nightsteelveil=夜钢面罩
nightsteelcirclet=夜钢头环
nightsteelchestplate=夜钢胸甲
nightsteelboots=夜钢靴
bloodplatecowl=血族头巾
bloodplatechestplate=血族胸甲
bloodplateboots=血族靴
spideritehelmet=蛛裔头盔
spideritehat=蛛裔帽
spideritehood=蛛裔兜帽
spideritecrown=蛛裔皇冠
spideritechestplate=蛛裔胸甲
spideritegreaves=蛛裔胫甲

// Cosmetic Armor
shoes=鞋子
shirt=衬衣
wig=头饰
farmerhat=农夫帽
farmershirt=农夫衬衫
farmershoes=农夫鞋
labcoat=实验室外套
labapron=实验室围裙
labboots=实验室靴
rainhat=雨帽
raincoat=雨衣
rainboots=雨靴
animalkeepershirt=动物饲养员的衬衫
animalkeepershoes=动物饲养员的鞋
smithingapron=熔炉围裙
smithingshoes=熔炉鞋
hardhat=安全帽
goldcrown=金皇冠
elderhat=长老帽
eldershirt=长老衬衫
eldershoes=长老鞋
safarihat=游猎帽
safarishirt=游猎衬衫
safarishoes=游猎鞋
hunterhood=猎人兜帽
huntershirt=猎人衬衫
hunterboots=猎人靴
magehat=法师帽
magerobe=法师袍
mageshoes=法师鞋
tophat=大礼帽
blazer=运动上衣
dressshoes=正装鞋
stylistshirt=造型师衬衫
stylistshoes=造型师鞋
merchantshirt=商人衬衫
merchantboots=商人靴
captainshat=船长帽
captainsshirt=船长衬衫
pirateboots=海盗靴
piratebandana=海盗头巾
pirateshirt=海盗衬衫
vulturemask=秃鹫面具
plaguemask=瘟疫面具
plaguerobe=瘟疫长袍
plagueboots=瘟疫靴
surgicalmask=手术面具
trapperhat=捕手帽
horsemask=马面具
horsecostumeshirt=马玩偶上衣
horsecostumeboots=马玩偶靴
christmashat=圣诞帽
partyhat=派对帽
pumpkinmask=南瓜面具
chickenmask=鸡面具
chickencostumeshirt=鸡玩偶上衣
chickencostumeboots=鸡玩偶靴
frogmask=青蛙面具
frogcostumeshirt=青蛙玩偶上衣
frogcostumeboots=青蛙玩偶靴
alienmask=外星人面具
aliencostumeshirt=外星人玩偶上衣
aliencostumeboots=外星人玩偶靴
spacehelmet=太空面具
spacesuit=太空上衣
spaceboots=太空靴
sunglasses=墨镜
jesterhat=小丑帽
jestershirt=小丑上衣
jesterboots=小丑靴
hulahat=夏威夷草帽
hulaskirtwithtop=女式夏威夷草裙
hulaskirt=男式夏威夷草裙
swimsuit=泳装
swimtrunks=泳裤
snowhood=雪兜帽
snowcloak=雪披风
snowboots=雪靴
sailorhat=水手帽
sailorshirt=水手服
sailorshoes=水手靴
empressmask=女皇面具
spoiledfood=变质的食物

// Food
wheat=小麦
sugarbeet=甜菜
flour=面粉
sugar=糖
honey=蜂蜜
rice=大米
groundcoffee=咖啡粉
beef=牛肉
rawmutton=生羊肉
rawpork=生猪肉
rabbitleg=兔子腿
duckbreast=鸭胸肉
frogleg=蛙腿
corn=玉米
tomato=番茄
cabbage=卷心菜
chilipepper=辣椒
eggplant=茄子
potato=土豆
carrot=胡萝卜
onion=洋葱
pumpkin=南瓜
strawberry=草莓
apple=苹果
lemon=柠檬
coconut=椰子
banana=香蕉
milk=牛奶
cheese=奶酪
blueberry=蓝莓
blackberry=黑莓
steak=牛排
roastedmutton=烤羊肉
roastedpork=烤猪肉
roastedrabbitleg=烤兔腿
roastedduckbreast=烤鸭胸肉
roastedfrogleg=烤蛙腿
roastedfish=烤鱼
bread=面包
candyapple=糖苹果
popcorn=爆米花
donut=甜甜圈
cookies=曲奇饼
candycane=拐杖糖
meatballs=肉丸子
smokedfillet=熏鱼片
blueberrycake=蓝莓蛋糕
blackberryicecream=黑莓冰淇淋
fruitsmoothie=水果冰沙
fishtaco=墨西哥鱼肉卷
juniorburger=汉堡包
cheeseburger=芝士汉堡
nachos=玉米片
eggplantparmesan=茄子帕尔马干酪
tropicalstew=热带炖菜
fishandchips=炸鱼薯条
freshpotatosalad=新鲜土豆沙拉
hotdog=热狗
ricepudding=大米布丁
minersstew=矿工炖菜
sushirolls=寿司卷
friedpork=炸猪排
bananapudding=香蕉布丁
lemontart=柠檬挞
spaghettibolognese=意大利番茄牛肉面
porktenderloin=猪里脊饭
beefgoulash=牛肉浓汤
shishkebab=羊肉串
pumpkinpie=南瓜饼
sweetlemonade=甘甜柠檬水
strawberrypie=草莓派
blackcoffee=黑咖啡
cappuccino=卡布奇诺

// Potions
healthpotion=生命药水
greaterhealthpotion=高级生命药水
superiorhealthpotion=超级生命药水
manapotion=魔法药水
greatermanapotion=高级魔法药水
superiormanapotion=超级魔法药水
speedpotion=速度药水
greaterspeedpotion=高级速度药水
webpotion=蛛网药水
healthregenpotion=生命恢复药水
greaterhealthregenpotion=高级生命恢复药水
manaregenpotion=魔法恢复药水
greatermanaregenpotion=高级魔法恢复药水
attackspeedpotion=攻速药水
greaterattackspeedpotion=高级攻速药水
invisibilitypotion=隐身药水
fireresistancepotion=防火药水
fishingpotion=钓鱼药水
greaterfishingpotion=高级钓鱼药水
battlepotion=战斗药水
greaterbattlepotion=高级战斗药水
resistancepotion=铁皮药水
greaterresistancepotion=高级铁皮药水
spelunkerpotion=洞穴探险药水
treasurepotion=宝藏药水
passivepotion=和平药水
buildingpotion=建筑药水
greaterbuildingpotion=高级建筑药水
miningpotion=采矿药水
greaterminingpotion=高级采矿药水
thornspotion=荆棘药水
strengthpotion=力量药水
rangerpotion=游侠药水
wisdompotion=智慧药水
minionpotion=召唤物药水
knockbackpotion=击退药水
rapidpotion=迅捷药水
greaterrapidpotion=高级迅捷药水
accuracypotion=精准药水
greateraccuracypotion=高级精准药水

// Consumables
recallscroll=回城卷轴
travelscroll=旅行卷轴
recallflask=回城魔瓶
stinkflask=恶臭魔瓶
portalflask=传送瓶
enchantingscroll=注魔卷轴
gatewaytablet=传送门牌

// Misc
craftingguide=合成指南
recipebook=配方书
voidpouch=虚空储物袋
voidbag=虚空背包
coinpouch=钱袋
ammopouch=子弹袋
ammobag=子弹包
potionpouch=药水袋
potionbag=药水包
lunchbox=午餐盒
portablemusicplayer=便携音乐播放器
fireworkrocket=烟花袋
woodboat=木船
minecart=矿车
shears=剪刀
bucket=桶
infinitewaterbucket=无尽水桶
rope=绳子
infiniterope=无尽绳子
binoculars=双筒望远镜
telescope=单筒望远镜
greenpresent=绿色礼物
bluepresent=蓝色礼物
redpresent=红色礼物
yellowpresent=黄色礼物
christmaspresent=节日礼物
greenwrappingpaper=绿包装纸
bluewrappingpaper=蓝包装纸
redwrappingpaper=红包装纸
yellowwrappingpaper=黄包装纸
landfill=填土方块
grassseed=草籽
swampgrassseed=沼泽草草籽
fertilizer=肥料
mysteriousportal=神秘传送门
royalegg=皇室之蛋
voidcaller=虚空呼唤者
spikedfossil=尖锐化石
ancientstatue=远古雕像
shadowgate=暗影之门
icecrown=寒冰皇冠
decayingleaf=腐烂之叶
dragonsouls=龙魂
swarmsignal=蝠群标志
slimeeggs=史莱姆蛋
crownofspiderkin=蛛魔皇冠
villagemap=本地村庄地图
dungeonmap=本地地牢地图
piratemap=本地海盗地图
importedcow=进口牛
importedsheep=进口羊
importedpig=进口猪
inefficientfeather=低级羽毛
jumpingball=跃动球
hoverboard=悬浮板
weticicle=潮湿垂冰
exoticseeds=奇异种子
steelboat=钢船
magicstilts=魔法高跷
demonheart=恶魔之心
lifeelixir=长生不老药
emptypendant=空挂件
piratesheath=海盗刀鞘
wizardsocket=法师插槽
vinyl=<name> 黑胶唱片

// Quest items
zombiearm=僵尸手臂
goblinring=哥布林戒指
babyswordfish=幼年剑鱼
spiderleg=蜘蛛腿
frozenbeard=冰冻胡须
swampeel=沼泽鳗鱼
babyshark=鲨鱼宝宝
crabclaw=螃蟹爪子
sandray=黄沙射线
fakefangs=虚假獠牙
slimechunk=史莱姆块
enchantedcollar=魔法颈圈
apprenticescroll=学徒卷轴
darkgem=暗黑宝石
slimylauncher=史莱姆发射器
mummysbandage=木乃伊绷带
magicsand=魔力沙子
caveoyster=洞穴牡蛎
capturedspirit=禁锢灵魂
pegleg=木制义肢
eyepatch=眼罩
rumbottle=朗姆酒酒瓶
deepspiritswab=深层灵魂拭子
brokenlimb=断肢
feraltail=野生尾巴
razoricicle=寒冰剃刀
slimesample=史莱姆样本
soakedbow=腐化之弓
wormtooth=蠕虫毒牙
crawlersfoot=爬虫足

[mob]
// Passive
sheep=羊
lamb=羊羔
wildostrich=野鸵鸟
cow=牛
calf=乳牛
pig=猪
piglet=乳猪
penguin=企鹅
polarbear=北极熊

// Critters
rabbit=兔子
squirrel=松鼠
snowhare=雪兔
crab=螃蟹
scorpion=蝎子
turtle=乌龟
swampslug=沼泽蛞蝓
frog=青蛙
duck=鸭子
bird=鸟
bluebird=蓝鸟
canarybird=金丝雀
cardinalbird=红雀
spider=蜘蛛
mouse=老鼠
caveling=穴居者

// Humans
human=村民
humanname=<name> 村民
farmerhuman=农夫
farmerhumanname=<name> 农夫
blacksmithhuman=铁匠
blacksmithhumanname=<name> 铁匠
guardhuman=守卫
guardhumanname=<name> 守卫
magehuman=法师
magehumanname=<name> 法师
gunsmithhuman=军火商
gunsmithhumanname=<name> 军火商
alchemisthuman=炼金术师
alchemisthumanname=<name> 炼金术师
hunterhuman=猎人
hunterhumanname=<name> 猎人
elderhuman=长者
elderhumanname=<name> 长者
anglerhuman=渔夫
anglerhumanname=<name> 渔夫
animalkeeperhuman=饲养员
animalkeeperhumanname=<name> 饲养员
pawnbrokerhuman=典当商
pawnbrokerhumanname=<name> 典当商
stylisthuman=造型师
stylisthumanname=<name> 造型师
piratehuman=失落海盗
piratehumanname=<name> 失落海盗
explorerhuman=探险家
explorerhumanname=<name> 探险家
minerhuman=矿工
minerhumanname=<name> 矿工
travelingmerchant=旅行商人
travelingmerchantname=<name> 旅行商人

// Hostile
zombie=僵尸
trapperzombie=猎手僵尸
goblin=哥布林
vampire=吸血鬼
zombiearcher=弓箭手僵尸
crawlingzombie=爬行僵尸
giantcavespider=洞穴巨蛛
blackcavespider=洞穴蜘蛛
swampcavespider=沼泽洞穴蜘蛛
cavemole=洞穴鼹鼠
frozendwarf=冰冻矮人
frostsentry=冰霜哨兵
swampzombie=沼泽僵尸
swampslime=沼泽史莱姆
swampshooter=沼泽弓箭手
enchantedzombie=附魔僵尸
enchantedzombiearcher=附魔弓箭手僵尸
enchantedcrawlingzombie=附魔爬行僵尸
voidapprentice=虚空学徒
mummy=木乃伊
mummymage=法师木乃伊
sandspirit=沙之灵
jackal=胡狼
skeleton=骷髅
skeletonthrower=投手骷髅
deepcavespirit=深层洞穴之灵
skeletonminer=矿工骷髅
ninja=忍者
snowwolf=雪狼
cryoflake=冰之花
giantswampslime=沼泽史莱姆
swampskeleton=沼泽骷髅
swampdweller=沼泽居民
smallswampcavespider=小型沼泽洞穴蜘蛛
sandworm=沙虫
desertcrawler=沙漠爬行者
ancientskeleton=上古骷髅
ancientskeletonthrower=上古投掷骷髅
ancientarmoredskeleton=上古装甲骷髅
ancientskeletonmage=上古骷髅法师
leggedslimethrower=有腿的投手史莱姆
mageslime=法师史莱姆
ghostslime=幽灵史莱姆
warriorslime=战士史莱姆
slimeworm=史莱姆蠕虫
cryptbat=墓穴蝙蝠
phantom=幻影
webspinner=织网蛛魔
bloatedspider=爆炸蜘蛛
spiderkin=蛛魔
spiderkinwarrior=战士蛛魔
spiderkinarcher=弓箭手蛛魔
spiderkinmage=法师蛛魔
cryptvampire=墓穴吸血鬼
humanraider=人类掠袭者

// Pets/spawned
spawnedname=<player> 的 <mob>
tameostrich=驯服的鸵鸟
petpenguin=宠物企鹅
petparrot=宠物鹦鹉
steelboat=钢船
petwalkingtorch=行走的火把
jumpingball=跃动球
hoverboard=悬浮板
babyzombie=僵尸宝宝
babyzombiearcher=弓箭手僵尸宝宝
babyspider=蜘蛛宝宝
frostpiercer=冰霜穿刺者
babysnowman=小雪人
playerpoisonslime=剧毒史莱姆
playervulturehatchling=秃鹫雏鸟
playerreaperspirit=收割者之魂
playercryoflake=冰花
playerpouncingslime=史莱姆
slimegreatswordslime=史莱姆巨剑史莱姆
babyskeleton=骷髅宝宝
babyskeletonmage=骷髅法师宝宝
orbofslimesslime=史莱姆之球史莱姆
playerchargingphantom=充能幻影
babyspiderkinwarrior=战士蛛魔宝宝
babyspiderkinarcher=弓箭手蛛魔宝宝

// Bosses/minions
evilsprotector=恶魔守卫
evilsportal=恶魔传送门
portalminion=传送门随从
queenspider=蜘蛛女王
spiderhatchling=蜘蛛幼仔
voidwizard=虚空巫师
piratecaptain=海盗船长
piraterecruit=海盗新兵
pirateparrot=海盗鹦鹉
ancientvulture=远古秃鹫
ancientvultureegg=远古秃鹫蛋
vulturehatchling=秃鹫雏鸟
reaper=收割者
reaperspiritportal=收割者之魂传送门
reaperspirit=收割者之魂
cryoqueen=冰雪女王
pestwarden=佩斯典狱长
swampguardian=沼泽守护者
swampguardianbody=沼泽守护者身体
swampguardiantail=沼泽守护者尾巴
sage=圣人
grit=砂砾
sageandgrit=圣人和砂砾
fallenwizard=堕落法师
fallendragon=堕落之龙
nightswarm=暗夜蝠群
nightswarmbat=暗夜蝠群蝙蝠
motherslime=史莱姆之母
spiderempress=蛛魔女皇

// Misc
woodboat=木船
minecart=矿车
sawblade=锯刃
homeportal=出生传送点
returnportal=返回传送点

[biome]
unknown=未知
forest=森林
plains=平原
desert=沙漠
desertvillage=沙漠村庄
swamp=沼泽
snow=雪地
snowvillage=雪地村庄
dungeon=地牢入口
forestvillage=森林村庄
piratevillage=海盗村庄
temple=圣殿
trialroom=试炼场
surface=<biome> 地面
cave=<biome> 洞穴
deepcave=<biome> 深层洞穴
slimecave=史莱姆洞穴
graveyard=墓园
spidercastle=蛛魔城堡
incursionhunt=<incursion> 追捕
incursionextraction=<incursion> 开采

[expedition]
completequests=完成更多营地任务
cave=洞穴
commonfishtrip=普通鱼类
swampcave=沼泽洞穴
snowcave=雪地洞穴
dungeon=地牢入口
desertcave=沙漠洞穴
pirate=海盗
deepcave=深层洞穴
deepsnowcave=深层雪地洞穴
deepswampcave=深层沼泽洞穴
deepdesertcave=深层沙漠洞穴
