
// Global ingredients
anysapling=任何树苗
anylog=任何木头
anystone=任何石头
anycommonfish=任何鱼类
anyrawmeat=任何生肉
bulletuser=任何任何使用子弹的枪
anycompostable=任何可堆肥物品
anyfruit=任何水果
anycoolingfuel=任何冷却燃料
anytieressence=任何等级 <tier> 的精华

[itemtooltip]
// Armor
headslot=头部槽位
chestslot=上身槽位
feetslot=脚部槽位
cosmeticheadslot=头部时装
cosmeticchestslot=上身时装
cosmeticfeetslot=脚部时装
cosmetic=时装物品
cosmeticslot=在时装槽中不提供任何加成
armorvalue=<value> 护甲
setbonus=套装加成：
ninjaset1=你tmd是个忍者！
ninjaset2=攻击时不受移速惩罚
ivyhoodset=5秒内对目标造成15点伤害
ivyhatset=攻击使目标中毒\n5秒内对目标造成15点伤害
ivyhelmetset=被攻击会滴落毒性伤害粘液
ivycircletset=在战斗中，\n偶尔生成毒史莱姆
quartzset=被击中后获得\n移动速度爆发\n20秒冷却时间
voidset=点击 [input=setability] 以获得移动速度爆发
tungstenset1=击退抗性
tungstenset2=增加50%击退
shadowhatset=魔法攻击会持续5秒对目标造成\n25点伤害
shadowhoodset=不移动时，+10%伤害
surgicalmasktip=让你周围的人更安全
spiderchest=减少击退
spiderset=攻击中毒目标会对其\n造成持续5秒的10点伤害\n对减速免疫
frostset=近战攻击会对目标造成\n减速以及持续5秒的15点伤害
glacialhelmetset=近战攻击将会射出冰柱
glacialcircletset=召唤攻击将会对目标减速
myceliumhoodset=点击 [input=setability] 将你固定在地上，增加100%远程攻击速度
myceliumscarfset=每次击中目标 +0.5%\n移动速度，最多100点
widowset=攻击中毒目标会对其\n造成持续5秒的25点伤害\n对减速免疫
ancientfossilset=点击 [input=setability] 以获得持续5秒的100%暴击率
slimeset=点击 [input=setability] 将所受伤害减少至1点\n但是显著增加击退，持续5秒
nightsteelset=点击 [input=setability] 以提升移速并且使敌人无法攻击自己\n但是自己也无法进行攻击，持续3秒
bloodplateset=受到伤害后生命恢复速度翻倍，持续4秒
spideriteset=点击 [input=setability] 在地面生成一串有毒的蛛网，持续10秒\n对减速免疫

// Trinkets
trinketslot=饰品槽位
trinketabilityslot=饰品能力槽位
useabilityslot=首先使用饰品技能槽
trinketdisabled=§h被 <items> 禁用
demonclawtip=免疫击退
polarclawtip=攻击使目标减速
finstip=游泳速度加倍
ninjasmark1=攻击时的移
ninjasmark2=速惩罚减半
piratetelescope=扩大一格旅行和群落的可用范围
leatherglovetip=攻击速度提高10%
trackerboottip=移动速度提高10%
shinebelttip=照亮你身边的区域
vampiresgift=增加15%移动速度
regenpendant=少量增加生命恢复速度
mobilitycloak=战斗外速度显著增加
travelercloak=战斗外在陆地和海洋速度增加
lifeline=受到致命伤时恢复25%血量\n5分钟冷却
magicfoci1=魔法伤害增加20%
magicfoci2=非魔法伤害降低20%
rangefoci1=远程伤害增加20%
rangefoci2=非远程伤害降低20%
meleefoci1=近战伤害增加20%
meleefoci2=非近战伤害降低20%
summonfoci1=召唤物伤害增加20%
summonfoci2=非召唤物伤害降低20%
balancedfoci=全类型伤害提高15%
ancientfeather=射弹速度增加50%
airvesseltip=增加2次冲刺次数
miningcharm=工具伤害增加40%
minersbouquettip=挖矿速度提高25%
minersbouquetusetip=摇摆以开启镇静效果
calmingminersbouquetusetip=摇摆以关闭镇静效果
cactusshieldtip=反伤攻击者
siphonshieldtip=将受到的伤害转换为魔法
sparegemstonestip=增加20%魔法上限
spellstonetip=增加50%魔法上限
dreamcatchertip=增加100%魔法恢复速度
nightmaretalismantip=增加250%魔法恢复速度
prophecyslabtip=增加100%魔法恢复速度
magicmanualtip=增加100%魔法恢复速度
scryingcardstip=增加250%魔法恢复速度
forbiddenspellbooktip=增加50%魔法伤害\n但是增加100%魔法消耗
magicalquiver=箭矢消耗减少75%
ammobox=子弹消耗减少75%
frozenhearttip=增加50点生命上限
frozenwavetip=暴击伤害提高25%
spidercharm=被攻击时，给予攻击者剧毒\n5秒内造成40点伤害
guardianshelltip=装备后按下 [input=trinketability] 可在短时间内获得强大护盾
fuzzydicetip=暴击几率增加5%
noblehorseshoetip=暴击几率增加5%
luckycapetip=暴击几率增加10%
bonehilt=护甲穿透增加20
firestonetip=攻击使目标燃烧\n5秒内造成25伤害
lifependant=增加生命恢复速度
constructionhammer=增加建造速度
telescopicladder=增加建造距离
toolextender=增加挖掘距离
itemattractortip=增加物品拾取范围
spikedboots=移动速度提高15%\n防滑
spikedbatboots=移动速度提高25%\n防滑
froststonetip=攻击对目标造成减速\n以及持续5秒的15点伤害
frostflametip=攻击对目标造成减速\n以及持续5秒的35点伤害
calmingrose=降低怪物生成
frenzyorbtip=根据失去的生命值，最多提供40%伤害加成
templependanttip=冲刺冷却时间减少25%
gelatincasingstip=射弹弹跳次数增加10
bloodstoneringtip=-20护甲\n50%以下血量时增加每秒4点生命恢复速度
claygauntlettip=增加10点韧性上限\n减少75%韧性衰减
vambracetip=增加50%韧性获取速度
chainshirttip=增加30点韧性上限
manicatip=增加50点韧性上限\n增加50%韧性获取速度
agedchampionscabbardtip=被动恢复韧性\n被击中后失去所有韧性
clockworkhearttip=将一半生命值转换为韧性\n满血时恢复韧性
challengerspauldrontip=附近有BOSS时增加100%韧性获取速度

// Tools
tooldmg=工具伤害： <value>
tooltier=工具等级： <value>
tooladdrange=<value>范围
pickaxetip=镐
shoveltip=铲
axetip=斧
demonictooltip=可以开采沙漠石英
tungstentooltip=可以开采黑曜石和深层雪地洞穴的冰川矿
glacialtooltip=可以开采深沼泽洞穴的菌丝矿石
myceliumtooltip=可以开采深沙漠洞穴的古代化石矿

// Weapons
damagetip=伤害： <value>
truedamagetip=真实伤害： <value>
meleedamagetip=近战伤害： <value>
rangeddamagetip=远程伤害： <value>
magicdamagetip=魔法伤害： <value>
summondamagetip=召唤物伤害： <value>
attackspeedtip=攻速: <value>
crittip=暴击几率： <value>%
knockbacktip=击退： <value>
resiliencegaintip=韧性获取: <value>
manacosttip=魔法消耗: <value>
lifecosttip=生命消耗: <value>
ammotip=备弹： <value>
arrowtip=可以用弓射出
cannonballtip=用于便携加农炮
boomerangstack=最大堆叠： <value>
bowtip=射出箭矢
greatbowtip=蓄力发射
guntip=射出子弹
greatswordtip=蓄力攻击
summonfocustip=使用[input=mouse2]进行聚焦
handcannontip1=射出炮弹
handcannontip2=弹药可在铁砧制作
machineguntip=有50%几率不消耗弹药
snowlaunchertip1=以雪球为弹药
snowlaunchertip2=有50%几率不消耗雪球
snipertip=带有狙击瞄准镜
deathrippertip1=有75%几率不消耗弹药
deathrippertip2=充能后射速增加
throwtip=可以扔出
heavyhammertip=射出小石子
lightninghammertip1=速度极快
lightninghammertip2=射出短程闪电
reaperscythetip=射出收割者镰刀
venomslashertip=射出一些毒液
speartip=只有头部会造成伤害
sparklertip1=射出一股熔化的金属
sparklertip2=攻击使目标燃烧
bloodbolttip=射出会返航的导弹
bloodvolleytip=射出三个会返航的导弹
froststafftip=射出2枚加速冰弹
voidstafftip=射出瞬发虚空激光
voidmissiletip=射出可控导弹(按住控制)
swamptometip=发射一颗缓慢移动\n和弹跳的射弹
genielamptip=射出水柱
destructivetip=摧毁物体
destructivetiletip=摧毁地面(地板)
venomstafftip=在地上放置毒液
dredgingstafftip=射出尖刺波纹
boulderstafftip=射出一块跳动的巨石
quartzstafftip=射出快速穿透射弹
vulturesbursttip=射出高速穿透射弹
elderlywandtip=射出可控穿透射弹(按住控制)
shadowbolttip=射出大型返航导弹
shadowbeamtip=射出瞬发暗影激光
dragonlancetip=射出火焰长矛
bloodgrimoiretip=[input=mouse1] 以生命为代价召唤一道魔法光线，命中时回血
bloodgrimoiresecondarytip=[input=mouse2] 标记敌人，魔法光线会同时对标记目标造成伤害
bloodclawtip=[input=mouse1] 切开面前的敌人，每击中一个敌人获得一个能量充能
bloodclawsecondarytip=[input=mouse2] 以生命为代价消耗所有的充能，释放毁灭性的打击
thecrimsonskytip=[input=mouse1] 向天空射出一支箭，在落地处留下一片造成伤害的区域
thecrimsonskysecondarytip=[input=mouse2] 以减少10点生命为代价，一次性射出5支箭
phantompoppertip=射出一个会爆出自动追踪射弹的泡泡
reaperscalltip1=召唤守卫灵魂
reaperscalltip2=一次最多5个
iciclestafftip=射出快速冰锥
boxingglovetip=伤害不高，击退很强
sprinttip=装备并按住 [input=trinketability] 来奔跑
zephyrcharmtip=增加50%耐力上限
zephyrbootstip=奔跑的速度更快，时间更长
shieldtip=装备并按住 [input=trinketability] 阻止敌人的攻击
shieldmodifier=抵挡 <percent> 的伤害
staminausertip=使用时消耗耐力
fowtipequipped=按[input=trinketability]向前推进
fowtipnotequipped=装备并按[input=trinketability]向前推进
fowtip2=可以在手中使用
blinksceptertip=装备后按下 [input=trinketability] 向前闪现
glacialbowtip=射中敌人时会分裂\n伤害附近敌人
druidsgreatbowtip=射出半空中会分裂的花瓣
nightpiercertip=箭矢撞击后爆炸
glacialboomerangtip=掷出后可控制
glacialboomerangtip2=一次掷出两个回旋镖
nightrazorboomerangtip=自动瞄准敌人
cryoquaketip=形成一条冰锥线
cryospeartip=攻击时释放一片碎片
swampdwellerstafftip=射出回弹的花朵
venomshowertip1=向敌人喷洒毒液
venomshowertip2=对更近的目标造成更多伤害
bowofdualismtip=一次射出两个射弹
bannertip=拿在手中给队友buff
razorbladeboomerangtip=空中最多存在5个
ancientdredgingstafftip=生成一个尖刺冲击波
carapacedaggertip1=可以重复投掷
carapacedaggertip2=自动瞄准敌人
sandknifetip=攻击使目标中毒\n在5秒内对目标造成500点伤害
brainonasticktip=召唤物弓箭手打手轮换
swampsgrasptip=召唤2个史莱姆
skeletonstafftip=召唤一对骷髅
slimestafftip=射出三个弹跳的射弹
slimecanistertip=召唤短命的剧毒史莱姆
slimegreatswordchargetip1=半蓄力可以发射史莱姆剑气
slimegreatswordchargetip2=满蓄力还可以召唤一个己方史莱姆
causticexecutionertip=攻击时从剑刃上投掷出危险的毒液
arachnidwebbowtip=一次射出3只箭矢
webweavertip=召唤一个具有魔法力量的蛛网，灼烧区域内的目标
empresscommandtip=交替召唤战士蛛魔和弓箭手蛛魔
secondarysummon=占用独立召唤槽
nettip=用于捕捉蜜蜂
slimegreatbowtip=从空中射下史莱姆粘液，大幅减缓敌人速度
orbofslimestip=召唤一个绕着你旋转的史莱姆，与敌人碰撞时造成伤害

// Food
nutritiontip=营养： <value>
foodqualitytip=品质: <quality>
spoilstime=<time>后变质
spoilstimewithrate=<time>后变质（<rate> 变质速度）
spoilingstopped=已停止变质
compostabletip=可用于堆肥

// Potions
consumetip=可以使用
hourduration=<value> 小时
hoursduration=<value> 小时
minduration=<value> 分钟
minsduration=<value> 分钟
secduration=<value> 秒
secsduration=<value> 秒
buffduration=持续时间：<time>
healthpot=立刻恢复<health>生命值
healthpottip=按 <key> 快捷键使用
manapot=立刻恢复<mana>%魔法
manaflatpot=立刻恢复<mana>魔法值
manapottip=按 <key> 快捷键使用
attackspeedpot=增加攻击速度
greaterattackspeedpot=大幅增加攻击速度
battlepot=提高10%伤害
greaterbattlepot=大幅提高15%伤害
greaterhealthregenpot=大幅增加生命恢复速度
healthregenpot=增加生命恢复速度
manaregenpot=增加魔法恢复速度
greatermanaregenpot=大幅增加魔法恢复速度
fireresistpot=防火
fishingpot1=渔力增加20%
fishingpot2=增加一条渔线
greaterfishingpot1=渔力增加30%
greaterfishingpot2=增加两条渔线
invispot=隐身
resistpot=护甲值增加8点
greaterresistpot=护甲值增加12点
speedpot=增加移动速度
greaterspeedpot=大幅增加移动速度
webpot=击中使目标减速
spelunkerpot=高亮矿石
treasurepot=高亮宝藏
passivepot=减少敌对怪物生成
buildingpot=增加地面(地板)和物体的放置速度
greaterbuildingpot=大幅增加地面(地板)和物体的放置速度
miningpot=增加开采速度
greaterminingpot=大幅增加开采速度
thornspot=反伤攻击者
strengthpot=近战伤害提高10%
rangerpot=远程伤害提高10%
wisdompot=魔法伤害提高10%
minionpot=召唤物上限+1
knockbackpot=增加击退效果
rapidpot=增加射弹速度
greaterrapidpot=大幅增加射弹速度
accuracypot=增加暴击几率
greateraccuracypot=大幅增加暴击几率

// Tiles
tiletip=可放置在绝大多数地形上
icetip=必须放在海边水中
stonepathtip=速度略微增加

// Objects
placetip=可以放置
bedtip=使用时用作重生点
seedtip=必须放置在农田上
flowertip=可以放在花盆里
graintip=可以喂给牲畜
milltip=可以在磨坊中磨粉
coolingfueltip=可以用作冷却燃料
activewiretip=激活导线
settlementflagtip1=用于建立一个营地
settlementflagtip2=必须放在地面上
settlementflagtip3=不能放在NPC村庄
tnttip=用导线激活后爆炸
fireworkdispensertip=用导线激活后发射烟花
activatedwiretip=用导线激活
ladderdowntip=用来下洞穴
deepladderdowntip=用来下深层洞穴
cartographertabletip=用于交换地图探索信息
placeinsettlement=必须在买到它的营地中放置
waystonetip1=放置后不能被捡起
waystonetip2=由营地内的法师出售
travelstonetip=用于长距离传送到附近的岛屿
compostbintip=缓慢生成肥料
grainmilltip=用于将谷物磨成粉
cheesepresstip=用于将牛奶做成奶酪
feedingtroughtip=用于给动物喂小麦
campfireaddontip=可在营火上放置
trainingdummytip=攻击它来测试伤害
dressertip=可储存盔甲
displaytip=展示储存的物品
bannerstandtip=在它附近施加旗帜效果
campfiretip=点亮时给予生命恢复效果
musicplayertip=播放黑胶唱片
christmastreetip=增添一些节日气氛
biggerthanitlookstip=比看起来还要大
coolingboxtip=减少储存物品的变质速度
incineratortip=随时间摧毁储存的物品

// Firework
fireworkrandom=随机
fireworkshape=形状： <shape>
fireworksphere=球形
fireworksplash=花形
fireworkdisc=瓣状
fireworkstar=星形
fireworkheart=心形
fireworkcolor=颜色： <color>
fireworkconfetti=五彩
fireworkflame=火光
fireworkred=红色
fireworkgreen=绿色
fireworkblue=蓝色
fireworkpink=粉色
fireworkrandomcrackle=随机响声
fireworknocrackle=没有响声
fireworkyescrackle=响声

// Misc
itemcount=<amount>全部物品
craftingmat=材料
mountslot=坐骑槽位
cointip=用于交易
baittip=钓鱼时使用
fishingrodtip=用于钓鱼
fishingpower=渔力： <value>
fishinglines=<value>条渔线
baitamounttip=可用诱饵：<value>
evilsevent=召唤一个强大的生物
royaleggtip1=召唤一个恐怖的爬行者
royaleggtip2=必须在雪地洞穴中使用
royaleggtip3=*检查 恐惧*
voidcallertip1=召唤虚空巫师
voidcallertip2=必须在地牢竞技场中使用
spikedfossiltip1=召唤一个强大的爬行生物
spikedfossiltip2=必须在沼泽洞穴中使用
ancientstatuetip1=召唤远古生物
ancientstatuetip2=必须在沙漠中使用
shadowgatetip1=召唤强大幽灵
reapersummontip=必须在森林深层洞穴中使用
icecrowntip1=召唤它的主人
icecrowntip2=必须在雪地深层洞穴中使用
decayingleaftip1=召唤百足兽
decayingleaftip2=必须在深沼泽洞穴中使用
dragonsoulstip=用于在深层沙漠洞穴中激活基座
slimeeggstip=召唤史莱姆洞穴BOSS
motherslimesummontip=必须在未完成的史莱姆洞穴中使用
swarmsignaltip=召唤墓园BOSS
nightswarmsummontip=必须在未完成的墓园中使用
crownofspiderkintip=召唤蛛魔城堡BOSS
spiderempresssummontip=必须在未完成的蛛魔城堡中使用
binocularstip=看得更远
wrappingpapertip=为你爱的人包装一下礼物吧
ropetip=可以捕捉绝大多数被动生物
biomemaptip=用于寻找周边的岛屿
mapfail=地图没有显示任何有用的信息
mapresult=地图显示的方向是 <dir> ，相对坐标为 (<coord>)
boattip1=在水中使用
boattip2=+1旅行距离
minecarttip=可以放置在轨道上\n或者装备到坐骑槽位使用
shearstip=用于给羊剪毛
buckettip=可以装液体
infwaterbuckettip=倒水装水都行
infwaterbucketplace=倒水
infwaterbucketpickup=装水
demonhearttip=永久提升生命上限至200
lifeelixirtip=永久提升生命上限10，但不能超过300
trinketinctip=永久提升饰品上限至 <number>
vinyltip=放入音乐播放器进行播放
recalltip=传送至重生点
homeportaltip=创建传送点
homeportalcleartip=[input=mouse2] 清除生成的传送点
stinkflasktip=用能吸引敌人的气味覆盖自己
enchantingscrollequipmenttip=用于给一件装备注入 <enchantment> 效果
enchantingscrollmeleetip=用于给一件近战武器注入 <enchantment> 效果
enchantingscrollrangedtip=用于给一件远程武器注入 <enchantment> 效果
enchantingscrollmagictip=用于给一件魔法武器注入 <enchantment> 效果
enchantingscrollsummontip=用于给一件召唤武器注入 <enchantment> 效果
enchantingscrolltooltip=用于给一件工具注入 <enchantment> 效果
singleuse=一次性使用
infiniteuse=无限使用
traveltip=传送到附近的岛屿
sickletip=收割作物时很有用
farmingscythetip=挥舞来光速收割成熟作物
cuttertip=用于移除逻辑导线
wrenchtip=用于放置逻辑导线
wrenchammo=可用的导线： <value>
enchantslot=附魔槽位
enchantfullstack=需要一组才能附魔
materialslot=锻造材料槽位
trashslot=垃圾桶
weaponslot=武器槽位
voidshardtip=魔法精华
glassbottletip=在炼金工作台中使用
gatewaymaterial=在堕落祭坛上使用
tieressence=等级 <tier> 精华
mapfragmenttip=收集两张来制作地图
sparepartstip=用于建造钢船
wiretip=可以用扳手来使用
queenbeetip=放置在养蜂场内以繁殖蜜蜂
honeybeetip=放置在养蜂场内以增加蜂巢数量
apiaryframetip=放置在养蜂场内以增加蜂蜜产量
gatewaytablettip=放置在堕落祭坛中以激活
recipebooktip=可以浏览所有配方
voidpouchtip=一个小型个人包裹
voidbagtip=一个大的个人物品袋
coinpouchtip1=可以保存得到的金币
coinpouchtip2=[input=-99]来取出金币
coinpouchstored=储存的金币：<coins>
ammopouchtip1=使用弹药时，优先使用袋内的弹药
ammopouchtip2=可以保存得到的弹药
potionpouchtip1=使用药水时，优先使用袋内的药水
potionpouchtip2=可以保存得到的药水
storedpotions=储存的药水： <items>
lunchboxtip1=存放拾取的食物
lunchboxtip2=使用吃里面的食物
storedfood=储存的食物：<items>
fireworkrockettip=可以在手中发射，也可以用发射器发射
storedammo=储存的弹药： <items>
rclickopentip=[input=-99]来打开
rclickinvopentip=在背包中[input=-99]来打开
rclickinvrenametip=在背包中[input=-99]来重命名
rclickinvopenerror=必须在自己的库存中
christmaspresenttip=里面装着什么？
usetoopentip=用于打开
landfilltip=可以用于填水
grassseedtip=用于种植草坪
fertilizertip=用于给作物加快生长
brokentooltip=可以熔化成锭或出售
portalnotonsurface=我需要在地面上
portalnotnight=这个东西在晚上才能使用
portalnospace=这里空间不足
portalerror=在这里不起作用
callernoarena=我不在地牢竞技场内
spawnmob=用于生成一个<mob>
summontip=用于召唤<mob>
summonquicktip=按 [input=-99] 快速召唤
summonmounttip=用于召唤<mob>坐骑
summonslots=最大同时存在个数：<count>
summonuseslots=使用<count>个召唤槽
steelboattip=+2旅行距离
jumpingballtip=有趣，并且适合所有人！
hoverboardtip=会缓慢增加速度
bouncingammotip=碰墙会弹跳
voidammotip=瞄准附近的敌人

// Quests
questitem=任务物品
zombiearmobtain=僵尸掉落
goblinringobtain=哥布林掉落
spiderlegobtain=黑色洞穴蜘蛛掉落
frozenbeardobtain=从冰雪洞穴中的冰冻矮人身上掉落
babyswordfishobtain=雪地洞穴捕鱼
swampeelobtain=沼泽地浅水区捕鱼
babysharkobtain=深水区捕鱼
crabclawobtain=沙漠螃蟹掉落
sandrayobtain=沙漠水中捕鱼
fakefangsobtain=吸血鬼掉落
slimechunkobtain=沼泽史莱姆掉落
enchantedcollarobtain=地牢中附魔生物掉落
apprenticescrollobtain=地牢虚空学徒掉落
darkgemobtain=地牢虚空学徒掉落
bookobtain=地牢书架中找到
slimylauncherobtain=沼泽射手掉落
mummysbandageobtain=沙漠洞穴中木乃伊掉落
magicsandobtain=沙漠洞穴中法师木乃伊掉落
caveoysterobtain=沙漠洞穴水中捕鱼
capturedspiritobtain=沙漠洞穴沙之灵掉落
peglegobtain=海盗掉落
eyepatchobtain=海盗掉落
rumbottleobtain=海盗掉落
deepspiritswabobtain=深层洞穴之灵掉落
brokenlimbobtain=骷髅掉落
feraltailobtain=雪狼掉落
razoricicleobtain=冰之花掉落
slimesampleobtain=史莱姆掉落
soakedbowobtain=沼泽居民掉落
wormtoothobtain=深层沙漠洞穴中沙虫掉落
crawlersfootobtain=深层沙漠洞穴中沙漠爬行者掉落

[itemcategory]
equipment=装备
tools=工具
pickaxes=镐
axes=斧
shovels=铲
fishingrods=钓鱼竿
weapons=武器
meleeweapons=近战武器
rangedweapons=远程武器
magicweapons=魔法武器
summonweapons=召唤武器
throwweapons=投掷武器
ammo=弹药
bait=鱼饵
armor=护甲
trinkets=饰品
cosmetics=时装
banners=旗帜
consumable=消耗品
rawfood=生食物
commonfish=普通鱼
food=食物
potions=药水
bossitems=BOSS物品
materials=材料
ore=矿石
minerals=矿物
bars=锭
stone=石头
logs=原木
specialfish=特殊鱼
flowers=花
mobdrops=掉落物
essences=精华
tiles=地面(地板)
floors=地板
liquids=液体
terrain=地形
objects=加载物体
seeds=种子
saplings=幼苗
craftingstations=制造站
furniture=家具
wallsanddoors=墙和门
fencesandgates=栅栏和栅栏门
traps=陷阱
wiring=导线
logicgates=逻辑门
misc=杂项
mounts=坐骑
pets=宠物
pouches=袋子
vinyls=黑胶唱片
questitems=任务物品
unknownitems=<count> 未知物品

[enchantment]
SAME_TRANSLATION:format=<enchantment> <item>

// Trinkets
keen=敏捷的
blunt=迟钝的
nimble=迅速的
sluggish=迟缓的
quick=快速的
clumsy=笨拙的
sturdy=坚定的
weak=虚弱的
precise=精确的
sloppy=草率的
bulky=庞大的
puny=微小的
magical=魔法的
draining=枯竭的

// Sword/melee weapon enchants
berserk=狂暴的
adamant=坚定的
agile=敏捷的
harmful=有力的
grand=巨大的
docile=温顺的
shoddy=劣质的
amateur=业余的
envious=嫉妒的

// Ranged weapon enchants
masterful=大师的
skillful=熟练的
tightened=牢固的
modern=现代的
trained=训练有素的
loose=松散的
eroding=宽松的
primitive=原始的
faulty=错误的

// Magic weapon enchants
divine=神圣的
wrathful=愤怒的
wise=明智的
adept=熟练的
apprentice=学徒的
decaying=腐朽的
novice=新手的
daft=愚蠢的
corrupt=腐化的

// Summon weapon enchants
savage=野蛮的
athletic=健壮的
mindful=智慧的
proud=荣耀的
aware=意识的
spoiled=过期的
sick=生病的
spiteful=恶意的
naive=天真的

// Tool enchants
master=大师的
shining=闪耀的
sharp=锋利的
absurd=晦涩的
used=破旧的

[buffmodifiers]
currentmodifiers=当前修饰器:
nomodifiers=无修饰器已启动
limitmax=最大值 <modifier>
limitmin=最小值 <modifier>

damage=<mod>% 伤害
meleedamage=<mod>% 近战伤害
rangeddamage=<mod>% 远程伤害
magicdamage=<mod>% 魔法伤害
summondamage=<mod>% 召唤物伤害
tooldamage=<mod>% 工具伤害
critchance=<mod>% 暴击几率
meleecritchance=<mod>% 近战暴击几率
rangedcritchance=<mod>% 远程暴击几率
magiccritchance=<mod>% 魔法暴击几率
summoncritchance=<mod>% 召唤物暴击几率
critdamage=<mod>% 暴击伤害
meleecritdamage=<mod>% 近战暴击伤害
rangedcritdamage=<mod>% 远程暴击伤害
magiccritdamage=<mod>% 魔法暴击伤害
summoncritdamage=<mod>% 召唤物暴击伤害
armorpen=<mod>% 护甲穿透
armorpenflat=<mod> 护甲穿透
knockbackout=<mod>% 击退

speed=<mod>% 速度
speedflat=<mod> 速度
slow=<mod>% 减速
swimspeed=<mod>% 游泳速度
friction=<mod>% 阻力
acceleration=<mod>% 加速度
deceleration=<mod>% 减速度

armor=<mod>% 护甲
armorflat=<mod> 护甲
incdamage=<mod>% 受到的伤害

maxhealth=<mod>% 血量上限
maxhealthflat=<mod> 血量上限
maxresilience=<mod>% 韧性上限
maxresilienceflat=<mod> 韧性上限
resiliencegain=<mod>% 韧性获取
resiliencedecay=<mod>% 韧性衰减
resiliencedecayflat=<mod> 韧性衰减
resilienceregen=<mod>% 韧性恢复
resilienceregenflat=<mod> 韧性恢复
maxmana=<mod>% 魔法上限
maxmanaflat=<mod> 魔法上限
basehealthregen=<mod>% 非战斗状态生命恢复
basehealthregenflat=<mod> 非战斗状态生命恢复
combathealthregen=<mod>% 生命恢复
combathealthregenflat=<mod> 生命恢复
basemanaregen=<mod>% 非战斗状态魔法恢复
basemanaregenflat=<mod> 非战斗状态魔法恢复
combatmanaregen=<mod>% 魔法恢复
combatmanaregenflat=<mod> 魔法恢复

poisondamage=<mod>% 中毒伤害
poisondamageflat=<mod> 中毒伤害
firedamage=<mod>% 燃烧伤害
firedamageflat=<mod> 燃烧伤害
frostdamage=<mod>% 霜冻伤害
frostdamageflat=<mod> 霜冻伤害

mobspawnrate=<mod>% 怪物生成速率
mobspawncap=<mod>% 怪物生成限值
mobspawnlightthreshold=<mod> 怪物生成光照阈值

attackspeed=<mod>% 攻击速度
meleeattackspeed=<mod>% 近战攻击速度
rangedattackspeed=<mod>% 远程攻击速度
magicattackspeed=<mod>% 魔法攻击速度
summonattackspeed=<mod>% 召唤攻击速度

miningspeed=<mod>% 开采速度
buildingspeed=<mod>% 建造速度

miningrange=<mod> 开采范围
buildingrange=<mod> 建造范围
itempickuprange=<mod> 物品拾取范围

arrowusage=<mod>% 箭矢使用概率
bulletusage=<mod>% 子弹使用概率
manausage=<mod>% 魔法使用概率
maxsummons=<mod> 最大召唤数量
summonsspeed=<mod>% 召唤物移动速度
summonstargetrange=<mod>% 召唤物追踪范围

attackmovement=<mod>% 攻击时移速惩罚
projectilevel=<mod>% 射弹速度
throwingvel=<mod>% 投掷物速度
projectilebounce=<mod> 射弹弹跳次数

dashstacks=<mod> 冲刺叠加
dashcooldown=<mod>% 冲刺冷却
dashcooldownflat=<mod>s 冲刺冷却
staminacap=<mod>% 耐力上限
staminausage=<mod>% 耐力消耗
staminaregen=<mod>% 耐力回复

traveldistance=<mod> 旅行距离
biomeviewdistance=<mod> 群落可视距离

knockbackin=<mod>% 抛掷距离
fishingpower=<mod>% 渔力
fishinglines=<mod> 渔线

waterwalking=允许水上行走
emitslight=开启照明
invisibility=开启隐身
spelunker=开启探险者模式
treasurehunter=开启寻宝者模式
bouncy=弹跳
paralyzed=瘫痪
untargetable=无法被攻击
intimidated=受到惊吓
manaexhausted=魔法耗尽
bloodmarked=鲜血标记

targetrange=<mod>% 仇恨范围
chaserrange=<mod>% 追逐范围
loot=<mod>% 战利品
enemydamage=<mod>% 敌人攻击
enemyspeed=<mod>% 敌人速度
enemymaxhealth=<mod>% 敌人最大生命值
enemiesretreating=敌人在撤退

// Items
toolknockback=<mod>% 击退
toolrange=<mod>% 范围



[mobmsg]
angryshop=无法与生气的人交谈
busyhuman=<name> 正忙
humanangry1=你这样做并不值得赞赏
humanangry2=啊，好痛！
humanangry3=请停下
humanangry4=你这样做是为了啥？
humanangry5=你为什么要这样做？
humanangry6=我做了什么，让你这样对我？

humanangryactive1=我只是想要帮你！
humanangryactive2=我只是想要做自己的事情！
humanangryactive3=停下，否则我会杀了你！

humanattack1=守卫，救命啊！
humanattack2=你会后悔的！
humanattack3=现在我啊，是真的生气了！
humanattack4=这是你最后的机会了！
humanattack5=警卫，我们中有敌人！
humanattack6=我们是时候做个了断了！

humantalk1=这附近是什么味道？
humantalk2=有时我只想躺在床上
humantalk3=你曾否仰望天空上的星星并陷入沉思？
humantalk4=我经常会想一些人生中的大问题。
humantalk5=你想过吗，我们为什么会在这里？ 答案很简单！

alchemisttalk1=我喜欢蘑菇
alchemisttalk2=我的试剂从来不会爆炸，我发誓。
alchemisttalk3=你也想来嗨一下吗？
alchemisttalk4=啥？没有，我可没有瞎下料！
alchemisttalk5=哈哈，为啥你说的事都那么搞笑？

anglertalk1=钓鱼不仅是我的爱好，更是我的生活
anglertalk2=总有一天，你也会体会到钓鱼的乐趣
anglertalk3=我这辈子见过不少稀奇古怪的鱼
anglertalk4=我能和我的鱼聊上一整天。
anglertalk5=钓鱼的时候可别忘了必要的饵料！
anglerspecial=<stylist>有没有对我的着装发表意见？

akeepertalk1=我可是一直在为您收集宠物！
akeepertalk2=我的梦想是将所有动物变成宠物。
akeepertalk3=我这有一些动物，我敢保证比你见过的都要奇特！
akeepertalk4=我的宠物很好养，只要一点时间去打理就好了
akeepertalk5=宠物可以是你一生的伴侣！
akeepertalk6=那些没有宠物的人是怎么活着的，真是无法理解
akeepertalk7=虽然有的宠物有点贵，但是它肯定值这个价！

blacksmithtalk1=我的锤子可不止是用来锻造！
blacksmithtalk2=做什么工作就用什么工具，这很重要！
blacksmithtalk3=你的剑该好好磨磨了。
blacksmithtalk4=瞧瞧我的这些宝贝吧！
blacksmithspecial=别把你的锭卖给<gunsmith>，他根本不会用！

eldertalk1=世界那么大，你该去看看。
eldertalk2=传说有的岛上有地牢，地牢里全是宝物
eldertalk3=年轻的探险家啊，我在你身上看到了潜力。
eldertalk4=在地下你能找到世界上最棒的矿物
eldertalk5=我这曾经只见过一次恶魔，万幸的是我能活着出来
eldertalk6=我能帮你什么吗？

farmertalk1=你见过我的儿子吗？
farmertalk2=你想打扮得像我一样吗？
farmertalk3=你对农业感兴趣吗？
farmertalk4=当我老的时候，我得找个人接管我的农场

gunsmithtalk1=狩猎之前，一定要记得练习
gunsmithtalk2=杀人的不是武器，而是人心
gunsmithtalk3=百里开外，没有比我这些还要致命的武器了。
gunsmithtalk4=我的货没有残次品，我发誓！
gunsmithspecial1=别把你的锭卖给<blacksmith>，他根本不会用！
gunsmithspecial2=<hunter>就是个疯子，枪才是唯一神！

huntertalk1=没有什么是弓箭解决不了的事情
huntertalk2=你知道弓的精髓在哪吗，那就是我！
huntertalk3=把苹果放在你的头上，我来给你表演一个
huntertalk4=你是富还是穷？
huntertalk5=我有让你想起某人吗？
huntertalkspecial=<gunsmith>就是个疯子，弓才是唯一神！

magetalk1=你对魔法感兴趣吗？
magetalk2=你可以拥有无限潜力…
magetalk3=有些魔法我们避而不谈。
magetalk4=过这村没这店了啊！
magetalk5=良马配好鞍，强大的武器就该附魔！
magetalk6=附魔能把属性提升一大截！
magetalk7=你可以找我附魔，也可以瞧瞧我的商品！

piratetalk1=有时候，我会怀念大海
piratetalk2=你有多的朗姆酒吗？
piratetalk3=你之前有找到过宝藏吗？
piratetalk4=我的锁丢了，你见过它吗？
piratetalk5=我的火药比你见过的任何火药都要好！
piratetalk6=总之，我不怎么喜欢我的海盗生活
piratespecial1=当时您的手下留情，我感激不尽！
piratespecial2=我当时没打伤你吧！

stylisttalk1=听说有人觉得我看起来像二次元？
stylisttalk2=生发可不是超能力！
stylisttalk3=想给别人留下深刻的印象吗？
stylisttalk4=何以解忧，唯有新衣！
stylisttalk5=我在周末正常上班！
stylisttalk6=本店一定会让您印象深刻！
stylisttalk7=想来个新发型，还是买条新裤子？
stylistspecial=<angler>居然选择了那种风格，难以置信！

tmerchanttalk1=我的商品和你本身一样稀奇
tmerchanttalk2=啊？我脱发了？
tmerchanttalk3=旅行既充满乐趣，也富含意义
tmerchanttalk4=想要来我这行干吗？
tmerchanttalk5=我应该找头骡子来驮货物
tmerchanttalk6=现在你明白为啥我的背包这么大了吧
tmerchanttalk7=我走遍五湖四海，这里算是个不错的地方

pawnbrokertalk1=放心，我的出价绝对公平！
pawnbrokertalk2=你要明白，我可不只是个收废品的
pawnbrokertalk3=有的时候，你需要一个我就够了
pawnbrokertalk4=很好，我可以借此大赚一笔！
pawnbrokertalk5=我不会诈你，我向你保证！
pawnbrokertalk6=不用你说，我知道我很帅气
pawnbrokertalk7=你这有茶来招待我吗？

tpawnbrokertalk1=那商人还没来吗，我刚刚还在海上碰见他了
tpawnbrokertalk2=你一直在等我？真让人感动

explorertalk1=我最喜欢的地方还是热带岛屿
explorertalk2=我也曾有过性命攸关的时候
explorertalk3=这里太无聊了，我想出去旅行！
explorertalk4=千里之行，始于足下，一双好鞋，一段好路！
explorertalk5=我希望我能找到他们口中的那些神殿。
explorertalk6=在我出发前记得提醒我带好水。
explorertalk7=说实话，野外生存很简单
explorertalk8=探索的时候千万记得提防陷阱
minertalk1=我这次又把梯子落在哪儿了？
minertalk2=洞穴很危险，最好带个武器！
minertalk3=这些洞里生的拿了我的矿石就跑！
minertalk4=好吧，我的火把又不够用了
minertalk5=我是爆炸艺术家！大多数情况下是的
minertalk6=君欲善挖矿，必先挑好镐！
minertalk7=你会只为了图一乐而坐矿车吗？

pirateattack1=兄弟们，上啊！
pirateattack2=交出你的朗姆酒然后滚蛋！
pirateattack3=我的火药能将你送上天！
pirateattack4=敌袭！敌袭！
pirateattack5=我们将会在你的尸体上喝朗姆酒狂欢！
pirateattack6=我的弯刀会将你碎尸万段！
pirateattack7=你会后悔踏上我们的岛！

pirateescape1=怕了吧！快滚吧！
pirateescape2=处理完毕！
pirateescape3=就这？下次再来吧！

[settlement]
notsettler=找不到定居者
thoughts=想法：
sizebaby=窄小
sizetiny=微小
sizesmall=小
sizemediocre=平庸
sizedecent=体面
sizelarge=大
sizehuge=巨大
sizeenormous=超大
sizemood=我住在一个 <size> 的房间
roomplain=朴素
roomdull=沉闷
roomsimple=简单
roomnormal=正常
roomgood=好
roomimpressive=令人印象深刻
roomwonderful=很棒
roomunrivaled=举世无双
roommood=我的房间家具选择是 <quality>
roommissingfloor=我的房间没有完整的地板
roommissinglights=我的房间太黑了
tinysettlement=这是一个微小规模的营地
smallsettlement=这是一个小规模的营地
averagesettlement=这是一个中等规模的营地
largesettlement=这是一个大规模的营地
hugesettlement=这是一个巨大规模的营地
nobed=我没有床
bedoutside=我的床在室外
foodsimple=简单
foodfine=还好
foodgourmet=美食
foodmood=我吃了 <quality> 食物
nofoodmood=我最近没有吃东西
dietsame=我的饮食一点都不多样化
dietslightly=我的饮食有一点多样化
dietsomewhat=我的饮食有些多样化
dietnicely=我的饮食非常多样化
dietextremely=我的饮食特别多样化
sharingroom=我在与其他定居者合住我的房间
moodveryunhappy=非常不开心
moodunhappy=不开心
moodsomewhathappy=有点开心
moodveryhappy=很开心
moodextremelyhappy=非常开心
moodhappiness=我感觉 <happiness>
moodtalkto=与定居者交谈以获取更多信息
moodhelp=快乐的定居者提供更好的商店价格和更短的工作休息时间
onworkbreak=我正在休息
onstrike=我不开心，我在罢工
onstrikehungry=我好饿，我在罢工
pawnbrokertip=完成远古秃鹫的系列任务
animalkeepertip=击败虚空巫师
foundinvillagetip=在村庄中找到
huntertip=出现在非村庄岛屿
magetip=出现在村庄或地牢中
piratetip=击败海盗船长
stylisttip=出现在村庄或海盗岛屿
explorertip=击败虚空巫师后出现在沙漠洞穴
minertip=击败恶魔守卫后出现在洞穴
travelingarrive=§a<mob> 正在抵达 <settlement>
travelingleave=§a<mob> 即将离开 <settlement>
defname=<biome> 营地

[buff]
healthpotionfatigue=生命药水冷却
manapotionfatigue=魔法药水冷却
manaexhaustion=魔法耗尽
onfire=起火
ablaze=燃烧
brokenarmor=护甲破损
teleportsickness=传送冷却
voidsetcooldown=虚空套装冷却
dashcooldown=冲刺冷却
lifelinecooldown=命悬一线冷却
webpotionslow=蛛网药水减速
spidervenom=蜘蛛毒液
widowpoison=寡妇毒素
chilled=寒冷
snowcovered=你浑身都是雪！
freezing=冰冻
frostburn=冰焰
frostslow=冰霜减速
sandknifewound=砂刃伤口
haunted=缠绕
ivypoison=常春藤药水
spidercharmpoison=蜘蛛之魅药水
slimepoison=史莱姆毒素
ninjasetbonus=忍着套装效果
summonedpet=已召唤宠物
summonedmount=已召唤坐骑
summonedmob=已召唤生物
movespeedburst=速度爆发
settlementflag=营地旗帜
campfire=营火附近
guardianshellcooldown=守护者之壳冷却
guardianshellactive=守护者之壳
ancientfossilsetcooldown=远古化石套装冷却
ancientfossilactive=远古化石套装
myceliumscarfactive=菌丝围巾叠加
slimedomeactive=史莱姆穹顶
nightsteelactive=夜钢套装
bloodplatecowlactive=双倍生命恢复
bloodclaw=血爪充能
bloodstonering=增加每秒4点生命恢复
bloodgrimoiredebuff=被血之魔典减速并标记
bloodgrimoirecooldown=血之魔典冷却
thecrimsonskycooldown=猩红苍穹冷却
slimesetcooldown=史莱姆套装冷却
nightsteelsetcooldown=夜钢套装冷却
spideritesetcooldown=蛛裔套装冷却
foodbuff=消耗的食物
fooddebuff=消耗的变质食物
hungry=饥饿
starving=极度饥饿
stamina=耐力

[bufftooltip]
canceltip=消除效果
nomodifiers=§9效果没有提供任何修正
teleportsicknesstip=无法传送
settlementflagtip=显著减少怪物生成
campfiretip1=减少怪物生成
campfiretip2=战斗外血量恢复
hungrytip=没有血量恢复
starvingtip=移动速度降低15%
manaexhaustiontip=降低魔法攻击速度



[richpresence]
atmainmenu=在主菜单
playingsingleplayer=单人游戏 - <location>
hostinginvite=主持 仅限邀请 世界 - <location>
hostingfriends=主持 仅限好友 世界 - <location>
hostingopen=主持 公开 世界 - <location>
playingwithfriends=与好友游玩 - <location>
playingonserver=在服务器上游玩 - <location>
unknownlocation=未知区域



[disconnect]
chatmsg=<name> 断开连接： <msg>
unknown=未知
internal=内部错误
kicked=断开连接: <reason>
noreason=没有原因
invalidname=无效的玩家名
clientresponding=无响应
serverstopped=服务器已关闭
servererror=服务器错误
clienterror=客户端错误
wrongpassword=密码错误
missingclient=客户端丢失
banned=您已被服务器禁止
wrongversion=客户端版本错误
alreadyplaying=已在游戏中
serverfull=服务器满员
nomessage=没有信息
missingappearance=外观缺失
networkerror=网络错误
networkerrormsg=网络错误：<msg>
statedesync=与服务器失去同步
inviteonly=仅限邀请
friendsonly=仅限好友
notresponding=在<seconds>秒未接收到服务器更新
respondingdc=服务器无响应
modsmismatch=模组不匹配

[deaths]
default= <victim> 死了
settlerfrom=<victim> 来自 <settlement>
unknownatt=未知
toobuffed=<victim> 太强壮了
generic1= <victim> 被 <attacker> 杀死了
generic2= <victim> 被 <attacker> 切片了
generic3= <victim> 被 <attacker> 羞辱了
generic4= <victim> 招架不住 <attacker> 
generic5= <attacker> 成功地克服了 <victim> 
generic6= <attacker> 靠速度战胜了 <victim> 
generic7= <attacker> 羞辱了 <victim> 
generic8= <victim> 招架不住 <attacker> 
projectile1= <victim> 被 <attacker> 爆头击杀
projectile2= <attacker> 给了 <victim> 关键一枪
projectile3= <victim> 被 <attacker> 成功抓获
evilsproj1= <victim> 被 <attacker> 扫地出门
evilsproj2= <attacker> 毁灭了 <victim> 
evilsproj3= <victim> 招架不住 <attacker> 
portalmin1= <victim> 被 <attacker> 惊吓致死
portalmin2= <victim> 把握不住 <attacker> 如潮的恐惧
portalmin3= <attacker> 将 <victim> 直接吓死
SAME_TRANSLATION:tntname=TNT
explosionname=爆炸
explosion1= <victim> 被轰杀至渣，原因是 <attacker> 
explosion2= <attacker> 炸死了 <victim> 
explosion3= <attacker> 使 <victim> 只剩下了碎片
firename=火
lavaname=岩浆
fire1= <victim> 对 <attacker> 没有任何防护
fire2= <attacker> 对 <victim> 来说有点烫
fire3= <victim> 被 <attacker> 活活烧死
life1=<victim> 使用 <attacker> 时消耗了过多生命
life2=<victim> 与 <attacker> 玩得有点过头了
life3=<attacker> 痛扁了 <victim>
starvationname=饿死
starvation1=<victim> 死于 <attacker>
starvation2=<victim> 没有找到任何食物
thorns1= <victim> 被 <attacker> 切成了碎片
thorns2= <attacker> 扎死了 <victim>
arrowtrapname=弓箭陷阱
flametrapname=火焰陷阱
flametrap1= <victim> 被 <attacker> 烤至金黄
flametrap2= <attacker> 烤熟了 <victim> 
spiketrapname=尖刺陷阱
spiketrap1=<victim> 被 <attacker> 刺穿了
spiketrap2=<attacker> 把 <victim> 穿成了一串
sawtrapname=锯刃陷阱
sawtrap1=<victim> 被 <attacker> 切成了两半
sawtrap2=<attacker> 把 <victim> 切成了薄片
lightning1= <victim> 因 <attacker> 的闪电化为灰烬
lightning2= <attacker> 被 <victim> 用电烤熟
zombie1= <victim> 被 <attacker> 千刀万剐了
zombie2= <victim> 被 <attacker> 羞辱了
zombie3= <attacker> 把 <victim> 吃干抹净
mummy1= <victim> 被 <attacker> 绑起来了
mummy2= <attacker> 对 <victim> 来说过于可怕
mummy3= <attacker> 对 <victim> 太过热情
skeleton1= <victim> 被 <attacker> 千刀万剐了
skeleton2= <attacker> 对 <victim> 来说过于可怕
skeleton3= <attacker> 对 <victim> 来说太难应付
polar1= <victim> 被 <attacker> 殴打了
polar2= <attacker> 靠速度战胜了 <victim> 
polar3= <victim> 被 <attacker> 屠杀了
vamp1= <attacker> 用假动作骗过了 <victim> 
vamp2= <attacker> 将 <victim> 带到了它的巢穴
vamp3= <victim> 忘记向 <attacker> 反击
voidwiz1= <attacker> 把 <victim> 变成了魔力之尘
voidwiz2= <attacker> 成功地在 <victim> 的进攻下守住了领地
voidwiz3= <victim> 挨了 <attacker> 太多次魔法攻击
voidwiz4= <attacker> 的魔法对 <victim> 来说太厉害了
voidapp1= <attacker> 给了 <victim> 一些颜色看看
voidapp2= <victim> 在 <attacker> 这里吃到了苦头
voidapp3= <attacker> 靠速度战胜了 <victim> 
piratecap1= <victim> 被 <attacker> 蜂拥而上
piratecap2= <attacker> 狠狠地打了 <victim> 的脸
piratecap3= <attacker> 成功地在 <victim> 的进攻下守住了领地
piratecap4= <victim> 招架不住 <attacker> 的加农炮
cavespider1= <victim> 被 <attacker> 撕烂了
cavespider2= <attacker> 的毒牙对于 <victim> 来说实在是太大了
cavespider3= <attacker> 活吞了 <victim> 

[tech]
all=所有的
inventory=库存
workstation=工作站
cookingpot=烹饪锅
roastingstation=烧烤台
cookingstation=烹饪工作站
forge=熔炉
carpenter=木工台
ironanvil=铁砧
alchemy=炼金工作台
demonic=恶魔工作站
advanced=高级工作站
fallen=堕落工作站
fallenalchemy=堕落炼金工作台
madein=可在 <tech> 中制造
madeinhidden=可在 <tech> 中制造（隐藏的配方）

[achievement]
complete=已完成
incomplete=未完成
track=追踪 <achievement>
chatcomplete=§a<player> 完成了成就： §7<achievement>
completedon=完成日期：<date>
spelunker=开启探险者模式
spelunker_desc=小心不要迷路了！
defeat_boss=许多中的第一个
defeat_boss_desc=打败第一个boss
get_pet=冒险的好伙伴
get_pet_desc=获得第一只宠物
start_settlement=自己动手，丰衣足食
start_settlement_desc=建立营地
set_spawn=光速睡眠
set_spawn_desc=重设出生点
enchant_item=能工巧匠
enchant_item_desc=在法师处给物品附魔
magical_drop=魔力果实
magical_drop_desc=增加饰品槽上限
village_helper=村庄小帮手
village_helper_desc=完成一个营地系列任务
hoarder=仓鼠
hoarder_desc=将一个库存塞满不同的物品
self_proclaimed=自我加冕
self_proclaimed_desc=戴上金皇冠
double_catch=一石二鸟
double_catch_desc=一次抛竿钓上两条鱼
complete_host=人丁兴旺
complete_host_desc=在同一营地内，让所有可以居住的NPC入住
getting_hot=热起来了
getting_hot_desc=抵达深层洞穴
my_jam=我的音乐
my_jam_desc=在音乐播放器上听黑胶唱片
cloud_nine=九霄云外
cloud_nine_desc=让定居者达到100%的幸福度
one_tapped=一击毙命
one_tapped_desc=一击杀死僵尸
too_easy=太简单了
too_easy_desc=在30秒内杀死一个魔王
headhunter=猎头
headhunter_desc=募你的第一个定居者
rematch=复赛
rematch_desc=击败堕落法师
defeat_pirate=冲上岸边
defeat_pirate_desc=击败海盗船长
grave_digger=掘墓人
grave_digger_desc=找到并挖出一块墓碑
equip_ability=瞧我的！
equip_ability_desc=装备你的首个技能饰品
obtain_items=博览众物
obtain_items_desc=获得全部可获得的物品
visit_biomes=旅行家
visit_biomes_desc=游历过所有不同的群落
fish_up=爱好之上
fish_up_desc=累计钓上500件物品
run_marathon=马拉松运动员
run_marathon_desc=步行距离达到马拉松全程距离
play_24h=浪费时间
play_24h_desc=游戏时间达到24小时

[loading]
foundmods=找到了 <mods> 个mod(s)
loadedmods=加载了 <mods> 个mod(s)
loadingmods=加载 Mod 中
patchmods=应用模组补丁
preinitmods=预加载mod
initmods=加载mod
initmodsres=加载mod资源
postinitmods=完成mod加载
biomes=加载群落
incursions=加载入侵
buffs=加载buff
items=加载物品
leveldata=加载关卡数据
levelevents=加载关卡事件
mobs=加载生物
objects=加载物体
pickups=加载掉落物
projectiles=加载射弹
textures=加载材质
sound=加载音频
shaders=加载着色器
commands=加载命令
tiles=加载地面(地板)
worlddata=加载世界数据
worldevents=加载世界事件
finishing=正在完成加载
mapshot=正在快照地图
loading=加载中
connecting=连接中
connectrecipes=加载配方 <percent>%
connectstats=加载玩家数据
connectworld=加载世界事件
connectlevel=加载关卡
connectplayers=加载玩家 <percent>%
connectclient=加载客户端
connectquests=加载任务
connectmap=加载地图 <percent>%

[jobs]
settlerincapable=营地不适合这种工作
jobrange=工作范围：<range> 格
incpriority=增加优先级
decpriority=降低优先级
haulingname=搬运
haulingtip=移动并搬运物品
craftingname=制造
craftingtip=在工作站制作特定配方
forestryname=林业
forestrytip=在林业区域内中砍树与种树
husbandryname=畜牧业
husbandrytip=在畜牧业区域内挤奶剪毛
fishingname=渔业
farmingname=种植业
farmingtip=收割与种植庄稼
fertilizename=施肥
fertilizetip=在施肥区给农作物施肥
huntingname=打猎
huntingtip=打猎食物

[activities]
unknown=未知
idle=空闲
onbreak=休息
onstrike=罢工中
inventoryfull=拥有完整的库存
hunting=狩猎 <target>
slaughtering=屠宰 <target>
pickingup=从<target>拾取<item>
theground=地面
droppingoff=在<target>放下<item>
droppingoffinv=储存物品
hauling=从<target>运输<item>
equipping=正在装备 <item>
harvesting=收获 <target>
consuming=消耗 <item>
planting=种植 <item>
milking=挤奶 <target>
shearing=剪毛 <target>
crafting=从<target>制作<item> 
fishing=垂钓
fertilizing=施肥 <target>
fillingapiary=填充蜂巢框
chopping=砍伐 <target>
attacking=攻击 <target>
movingtoposition=前往位置
watchingfortargets=寻找目标
following=跟随 <target>
resting=睡眠
hiding=躲藏中
onmission=执行任务

[ui]
travelbutton=旅行
dirnorth=北
dirwest=西
direast=东
dirsouth=南
dirnorthwest=西北
dirnortheast=东北
dirsouthwest=西南
dirsoutheast=东南
traveldir=向 <dir> 旅行
scoreyour=你的岛屿
scoredirup=在你之上
scoredirdown=在你之下
scoredirunknown=未知地点
SAME_TRANSLATION:latencytip=<latency> ms
healthbartip=生命 <value>
resiliencebartip=韧性 <value>
hungerbartip=饥饿 <value>
manabartip=魔法 <value>
respawn=重生
respawnin=在 <seconds> 后可复活
totalarmor=总护甲值：<armor>
waitingplayers=正在等待玩家 <count>/<total>
filteronlycraftable=仅在工作台制作
changefilters=修改过滤器
craftfilters=制造过滤器
showhidden=显示隐藏
craftshowhiddentip=部分配方已隐藏，直到你拥有全部材料或特定材料才会显示
usenearbyinv=使用附近的库存
usenearbyinvtip=制造时将使用附近库存的物品
expand=展开
collapse=折叠
fuel=燃料
fuelkeeprunning=保持运行
needfuel=需要燃料
shopnoitems=没有物品
shopselltip=§a得到 <coins>[item=coin] 金币，卖出 <amount>:
shopbuytip=§a付出 <coins>[item=coin] 金币，购买 <amount>:
insertmat=在槽位中放入制造材料
waystoneinvalidhome=§6找不到传送石碑
waystonenoslots=§6没有空的 路径石碑 槽位
waystoneinvalid=§6找不到 路径石碑
homeportalinvalid=§6找不其他其他传送点
currenttime=当前时间：<time>
timemorning=早上
timenoon=中午
timeafternoon=下午
timeevening=傍晚
timenight=晚上
hotkeytip=快捷键： <hotkey>
loadingdotdot=等待中...
dontshowagain=不再显示
searchtip=搜索
confirmnosave=你确定你不想先保存一下吗？
backbutton=返回
buybutton=购买
confirmbutton=确定
continuebutton=继续
selectbutton=选择
acceptbutton=同意
declinebutton=拒绝
cancelbutton=取消
closebutton=关闭
disconnectbutton=断开连接
copybutton=复制
pastebutton=粘贴
clonebutton=复制
changecolorbutton=改变颜色
moveupbutton=向上移动
movedownbutton=向下移动
increasebutton=增加
decreasebutton=减少
removebutton=移除
deletebutton=删除
configurebutton=配置
hidebutton=隐藏
showbutton=显示
allowallbutton=同意全部
clearallbutton=清除全部
savebutton=保存
dontsavebutton=不保存
renamebutton=重命名
wakeupbutton=唤醒
setspawnbutton=设置出生点
clearspawnbutton=清除出生点

// Main menu
continueworld=继续游戏
continuetip=继续：<world>
continuehost=继续主持 <world>
continuejoin=继续加入 <name>
newworld=新的游戏
loadworld=加载游戏
hostworld=主持游戏
multiplayer=多人游戏
settings=设置
mods=Mod
exit=退出
join=加入 <name>
joinfriend=加入好友的世界
nofriendsingame=没有好友在游戏中
joinfriendhow=请确认你的好友已经通过主菜单主持了游戏
selectworld=选择世界
createnewworld=创建新世界
loadsave=加载
confirmdeleteworld=删除世界 "<world>" 吗？
deletesave=删除
backupsave=备份
restoresave=恢复
renamesave=重命名
renametaken=名字已被使用
renameworld=重命名世界：
nosavestip=没有存档，请选择新的游戏。
selectcharacter=选择角色
createnewcharacter=创建新角色
nocharacterstip=没有找到已保存的角色，请先创建新角色
confirmdeletecharacter=删除角色 "<character>" 吗？
renamecharacter=重命名角色：
characterplaytime=已游玩 <time>
characterlastworld=最后一次游玩在世界 <world>
characterlastfriendsworld=一个好友的世界
characternotplayed=尚未游玩
characterjustcreated=刚刚创建
characterfromworld=在世界中发现角色
downloadcharacter=从世界下载角色
loadnewchararacterwarning=警告：\n\n选择该角色将永久删除旧角色\n\n你可以先返回并下载角色\n\n确定要继续吗？
characterworldcheats=此世界已开启作弊\n选择一个没有启用作弊的角色也将在该角色上启用作弊
characterisclean=未开启作弊
characterhascheats=已开启作弊
charactercheatserror=该角色无法在此世界使用，因为曾在启用作弊的世界中使用过
loadcheatscharacterwarning=警告：\n\n选择该角色将禁用此世界的成就系统\n\n确定要继续吗？
loadcleancharacterwarning=警告：\n\n选择该角色将禁用成就系统，并且无法在禁用作弊的世界上使用此角色\n\n确定要继续吗？
savetip=天数 <day>， 时间： <time>
refreshservers=刷新
addserver=添加服务器
deleteserver=删除服务器
confirmdeleteserver=删除服务器： “<server>” ？
joinserver=加入服务器
directjoin=直接连接
unknownaddress=未知地址
searchinglan=正在搜索局域网......
searchlandone=局域网搜索完成
correctversion=正确的游戏版本
wrongversion=客户端版本错误
serverversion=服务器版本：<version>
passwordprotected=服务器设有密码
serversettings=服务器设置：
survivalmode=生存模式
survivalmodetip=在生存模式下，食物会变质，玩家会因饥饿而死亡，定居者饥饿时间过长时会离开营地
hungerdisabled=饥饿：禁用
hungerenabled=饥饿：启用
mobsdisabled=生物生成：禁用
mobsenabled=生物生成：启用
forcepvpon=强制PvP：启用
forcepvpoff=强制PvP：关闭
selectdifficulty=选择难度
changedifficulty=难度变更
difficultyeffects=附加效果
difficulty=难度
difficultytip=<difficulty> 难度
diffcasual=休闲
diffcasualdesc=轻松、休闲的体验，有最少的战斗和挑战
diffcasualeffects=显著降低所受伤害\nBOSS生命显著降低\n敌人生成速度降低\n掠袭者伤害降低
diffadventure=冒险
diffadventuredesc=为那些想有轻松体验，减少战斗，但偶尔迎接挑战的玩家设计
diffadventureeffects=降低所受伤害\nBOSS生命降低\n敌人生成速度略微降低\n掠袭者伤害略微降低
diffclassic=经典
diffclassicdesc=为那些追求挑战的玩家打造，你需要随时思考战斗策略并做好准备
diffclassiceffects=无附加效果
diffhard=困难
diffharddesc=为那些寻求更大挑战的玩家打造，往往需要优秀的策略、灵活的动作和充分的准备
diffhardeffects=提升所受伤害\nBOSS生命提升\n敌人生成速度略微增加\n击退效果降低\n掠袭者伤害略微增加
diffbrutal=残酷
diffbrutaldesc=为老练的玩家打造，出色的策略、闪避和周密的准备缺一不可
diffbrutaleffects=显著提升所受伤害\nBOSS生命显著提升\n敌人生成速度增加\n击退效果显著降低\n掠袭者伤害增加
deathpenalty=死亡惩罚
dptip=死亡时： <penalty>
dpnone=无惩罚
dpdropmats=掉落材料
dpdropmatstip=除去装备、战斗和特殊物品，其他物品都会掉落
dpdropmain=掉落主背包
dpdropmaintip=除去装备栏和快捷栏物品，其他物品都会掉落
dpdropfull=掉落全部物品
dpdropfulltip=身上的全部物品都会掉落
dphardcore=硬核
dphardcoretip=死了不能复活
raidfrequency=突袭频率
raidsoften=经常
raidsoccasionally=偶尔
raidsrarely=很少
raidsnever=从不
wschangetip=注意：你可以在设置中随时更改世界设置
showadvanced=按住SHIFT查看详细信息
daymod=白天时长： <mod>
nightmod=晚上时长： <mod>
connectserver=连接
connectcancel=取消
charcreate=创建
addconfirm=添加
passwordreq=服务器需要密码
namedesc=名称：
nameexample=仅显示名称
ipdesc=IP地址：
ipexample=例：127.0.0.1
portdesc=端口：
portexample=例：14159 或 9001
hostport=主机端口
playerslots=玩家上限
password=密码
passwordtip=留空以不设置密码
hoststart=主持
rotate=旋转
hair=头发
haircolor=头发颜色
skin=皮肤
eyes=眼睛
shirtcolor=衬衫颜色
shoescolor=鞋子颜色
selectcolor=选择颜色
colorred=红
colorgreen=绿
colorblue=蓝
resetappearance=默认
undoreset=撤销重置
randomappearance=随机
customspawn=自定义出生岛
xcoord=X坐标
ycoord=Y坐标
spawnguide=生成向导房间
disablespawns=关闭生物生成
daymodnew=白天时长修正值
nightmodnew=晚上时长修正值
spawnsettings=生成设置
spawnseed=生成\n种子
resetseed=重置
playername=玩家名
playernamesize=名称必须在4~20字符之间
playernamesymbols=名称中含有非法字符
characternameinuse=此世界已有名为 "<name>" 的角色
outsidecharactersnotallowed=此世界不接受外部角色
chooseworldname=为你的世界取个名字
createworld=创建世界
moresworldettings=更多世界设置
worldsettings=世界设置
worldadvanced=高级
hostnewworld=主持新的世界
selectsave=选择
steamlobbytype=服务器可见性
steamlobbyinvite=仅限邀请
steamlobbyfriends=仅限好友
steamlobbyopen=公开
steamlobbypublic=公开
allowconnectbyip=允许IP连接
peacefulbox=和平
playerhungerbox=开启玩家饥饿
forcedpvpbox=强制PvP
allowoutsidecharactersbox=允许外部角色
rememberpass=记住密码
waitserver=等待服务器关闭......
modenable=开启
moddisable=关闭
moddisabled=模组当前已禁用
modfromdev=从开发文件夹加载
modfromfolder=从 mods 文件夹加载
modfromworkshop=从 Steam 创意工坊加载
modopenworkshop=在 Steam 创意工坊中打开
modupload=上传到 Steam 创意工坊
moduploadexamplepackage=您的模组不允许位于“示例模组”下。在上传之前更改路径。
moduploadselect=创建新项目或选择要更新的项目
moduploadcreatenew=创建新项目
moduploadupdatedesc=更新描述（以后始终可以更改）：
moduploadselecttags=选择适合您的模组的标签：
moduploadtermsagree=为了上传，您必须同意 Steam 创意工坊的服务条款
moduploadtermsopen=打开链接
moduploadmine=您应该只上传您自己创建的内容。\n\n您确认此内容是您自己创建的吗？
moduploadfolderinvalid=开发模组必须是一个目录，里面有一个jar文件。如果使用示例模组，请尝试运行 Clean Gradle。
moduploadnotaccepted=您没有接受 Steam 创意工坊的服务条款。请再试一次。
moduploadcreatefailed=无法创建文件: <message>
moduploadcreating=创建文件中...
moduploadupdating=更新文件中...
moduploadsuccess=成功地创建/更新了模组
modsloadorder=模组加载顺序:
modsinfoselect=选择一个模组来查看描述
SAME_TRANSLATION:modinfoid=ID: <id>
modinfoname=名称： <name>
modinfoversion=版本： <version>
modinfogameversion=游戏版本： <version>
modauthor=作者: <author>
modclientside=服务器或连接的客户端不需要这个模组
moddescription=描述： <description>
modinfodep=依赖：
modinfooptdep=可选依赖：
modwronggameversion=错误的游戏版本
modmissingdep=缺少依赖或错误的加载顺序
moderrorwarning=此模组导致错误。查看最新日志以了解详细信息并联系作者。
modssavenotice=警告：\n必须重启游戏才能使设置生效
modsquit=退出
modslater=一会再做
modsempty=没有找到模组
SAME_TRANSLATION:modsalpha=ALPHA
modsalphatip=模组设置仍处于非常早期的阶段.\n在使用此功能时，你可能会遇到破坏游戏的错误
modiniterror=初始化模组时出错\n"<mod>"\n查看最新日志以获取详细信息。
modrunerror=一个错误导致了模组加载失败: <mod>\n 请尝试使用以下日志与作者联系，或禁用模组。
moddederror=运行模组时发生了一个错误。
moderrordisablethis=禁用该模组
moderrordisableall=禁用所有模组
modmismatch=你的模组与服务器不匹配
modmismatchworld=您的模组与之前用于这个世界的模组不匹配 \n 加载一个模组不匹配的世界可能会导致数据丢失。
modmatch=你的模组与服务器匹配
modloadsaveanyway=保持加载
modreview=检查
servermods=服务器模组
worldmods=世界模组
mymods=我的模组
useservermods=使用服务器模组
useworldmods=使用该世界的模组
nomodsused=没有模组使用
modmissing=缺少
modinversion=版本错误
modinposition=未知错误
modmissingsome=缺少部分模组
givefeedback=反馈
givefeedbacktip=感谢所有的反馈意见!
sendfeedback=发送反馈
sendingfeedback=正在发送..
sendfeedbackerr=发送反馈时出现未知错误
sendfeedbackfail=无法发送反馈，请重试！
sendfeedbackwaittime=等待 <time>
crashsorry=十分抱歉，游戏崩溃了 :(\n请发送反馈来帮助开发者解决问题
crashshowlog=显示细节
crashgivedetails=请描述发生崩溃时的细节，比如你正在做什么。
crashdetailshere=键入细节(可选)
dontsendreport=不发送反馈
sendreport=发送反馈
sendingreport=正在发送..
sendreporterr=发送反馈时出现未知错误
sendreportfail=无法发送反馈，请重试！
sendreportthanks=十分感谢！
sendreportretry=重试
camerapantoggle=切换镜头平移

// Achievements and stats form
achievementsandstats=成就与统计数据
achievements=成就
achdisabled=禁止获得成就
achenabled=可以获得成就
achdisabledhelp=这个世界不能获得成就，也不会计入统计信息。成就无法在作弊的世界中获得。此过程不可逆，如果需要获取成就，就必须创建一个新的世界。
showcompleted=显示完成的成就
statsnotfound=无统计资料
playerstats=人物统计资料
playerstatstip=所有世界的统计资料
psdisabled=禁用玩家资料
globalstats=全球统计资料
characterstats=人物统计资料
characterstatstip=当前任务统计资料
worldstats=世界统计资料
worldstatstip=当前世界统计资料
gotinvite= <name> 邀请一起游戏

// Pause menu
resumegame=继续
invitefriends=邀请好友
playinggame=正在游玩： <game>
playingother=正在游玩其他游戏
invite=邀请 <name>
invited=已邀请 <name>
couldnotinvite=无法邀请 <name>
tomain=回到主菜单
statusonline=在线
statusoffline=离线
statusaway=离开
statusbusy=忙碌
statusSnooze=瞌睡
statuslookingtoplay=寻找玩伴
statuslookingtotrade=寻找交易

// Player
SAME_TRANSLATION:pvplabel=PvP
teamcreate=创建队伍
teamcreateleave=在创建新队伍之前离开当前队伍
teamjoinateam=加入队伍
teamnoteams=没有队伍可以加入
teampublic=公开
teamprivate=私有
teammembercount=队员： <count>
teamjoin=加入队伍
teamrequestjoin=请求加入
teamownerisnotonline=队伍所有者目前不在线
teamjoinrequests=加入请求
teamcanselfjoin=队伍可加入
teamcreated=创建了新队伍 <name>
teamleave=离开队伍
teamleaved=离开了<name> 队伍
teamleaveconf=要离开队伍吗？
teamleaveneedinvite=你必须获得邀请才能再次加入
teamnocurrent=你现在不属于任何队伍
teaminvited=邀请 <name> 加入 <team>
teamowner=队长：<owner>
teamchangename=更改队伍名称
teaminvite=邀请玩家
teaminviteselected=邀请选中的玩家
teammembers=成员
teamkick=请出 <name>
teampassowner=转让队伍所有权
teaminvites=邀请
teamnoinvites=你没有邀请
diedlabel=你死了
settlement=营地
settlementsurface=仅限地表
pvpandteams=PvP和队伍
adventurepartyleftnofood=§a<name> 因为缺少食物离开了冒险队
adventurepartyleftrecall=§a<name> 回城了，因为他们的生命值较低
confiureadventureparty=配置冒险队
adventureparty=冒险队
adventurepartytip=冒险队成员会略微增加敌人生成速率和BOSS生命值
adventurepartysize=当前队伍规模: <size>
adventurepartycommand=命令队伍
adventurepartycommandall=选择全部成员
adventurepartyinventory=队伍背包
adventurepartyinventorytip=为你的队伍成员添加食物和药水，添加回城卷轴将使定居者在生命值较低时使用它们
adventurepartyinventorycompress=整理背包
adventurepartycantaddempty=无法向空冒险队添加物品
buffpotionpolicy=Buff药水使用策略：
buffpotionpolicyalways=总是使用
buffpotionpolicyincombat=仅在战斗中使用
buffpotionpolicysameasme=与我相同
buffpotionpolicyonhotkey=当我按下buff快捷键
buffpotionpolicynever=永不使用
quests=任务
noquests=你没有任何任务可做
tracknewquests=追踪新任务
maphide=隐藏
mapshow=显示
toggleautodoor=切换自动开门
lockhotbar=锁定快捷栏
unlockhotbar=解锁快捷栏
hotbarlockedtip=锁定快捷栏会停止将物品拾取到栏位，并且无法在库存关闭时选择栏位上的物品
anchortip=锚

// Containers
elderheader=我能帮你做什么？
elderquest=营地任务
elderwantquest=我正在寻找任务
elderquestintro=你做好了我就给你奖励！
eldernoactive=如果你放一个营地旗帜，我就给你一些任务！
eldernoquest=无可用营地任务
eldernoaccess=如果你加入这个营地队伍，我会为你找到一些任务！
elderacceptquest=接受任务
eldercompletequest=完成任务
elderskipquest=更换任务
eldertiercompleteerr=请先完成 <count> 个任务
elderbiggerchallenge=我正在找一个更大的挑战
elderifready=如果你准备好了，我这里有任务
eldernotierquest=我没有更多像那样的任务了
eldernotready=我还没准备好
elderskipquesttime=当前无法更换任务
eldertips=提示
eldernexttip=下一个
elderprevtip=上一个
eldertip1=地下有许多资源和财宝，\n而去地下只要一个梯子
eldertip2=有些配方被隐藏了，\n只有获得全部材料才能显现
eldertip3=用这本合成指南来查看\n需求某种材料的配方
eldertip4=有的岛上有村庄，\n里面有可进行交易的人
eldertip5=地牢的尽头由一个强大的巫师看守
eldertip6=如果你找到了那个传送门，\n你就可以用它召唤一个强大的恶魔
eldertip7=钓鱼可以获得许多制造药水的材料
eldertip8=身着整套护甲的时候，\n通常都会有额外的套装效果
eldertip9=可交易的人们每天都在变换价格，\n争取在最好的那天去交易
eldertip10=建立你自己的营地，\n这样就能方便地交易
eldertip11=有的商人在你打败特定怪物后\n会出售额外的物品
eldertip12=在沙漠洞穴中，\n你能找到一个强大的生物
eldertip13=如果你在找新的作物，\n你可以去找农民买点
eldertip14=像动物饲养员和垂钓者这样的定居者将在你的营地周围通过他们的职业一展拳脚
eldertip15=如果你觉得游戏太简单或太困难，你可以随时在世界设置中更改难度
elderhelpbutton=了解一些事情
elderpicktopic=你想知道些什么？
eldercrafting=制造
eldercraftingtip=所有带有“材料”标签的物品都可以用于制造。\n你可以手工合成简单的物品，\n诸如工作站和铁砧这样的制造站\n可以制造更高级的物品。\n要显示特定的制造，可以使用过滤器。\n将物品放在以下槽位可以查看使用它的合成配方。
elderexploring=探索
elderexploringtip=游泳或乘船来到地图边界后，\n就可以选择前往不同的岛屿。\n只要你来过某个岛屿，地图上就会标记它的群系。\n有些岛屿较为危险，实力不足时应当暂避锋芒。
eldertrading=交易
eldertradingtip=有些村庄岛屿中有可交易的人，\n他们会买卖一些有关他们职业的物品。\n相同职业的人所买卖的物品和价格都可能不同。\n建立一个营地可以让他们入住。
elderobjects=物体
elderobjectstip=物体是世界中存在的事物：\n有些具有碰撞体积、有些可以互动。\n使用斧或是镐来破坏它们。
eldertiles=地面(地板)
eldertilestip=地面(地板)是你行走(游泳)的平面，\n有些物体只能放在特定的地面(地板)上。\n通常可以用铲子来破坏并拾起地面(地板)。
eldertools=工具
eldertoolstip=游戏早期的工具可以在铁砧中制造：\n镐用来采集岩石、斧用来采集木制品、\n铲子用来采集地面(地板)。\n有些物体需要更高级的工具才能破坏。
elderweapons=武器
elderweaponstip=游戏早期的武器可以在铁砧中制造。\n更高级的武器可以在世界各地的箱子中找到。\n武器的种类繁多，\n比如剑、弓、枪、回旋镖和魔法武器等。
elderarmor=防具
elderarmortip=游戏早期的防具可以在铁砧中制造。\n装备全套防具通常会提供套装加成。\n时装栏的防具不会提供任何效果，\n但是会改变人物的外观。
eldertrinkets=饰品
eldertrinketstip=饰品通常可以在世界各地的箱子里找到，\n也可以通过合成获得。\n它们会提供各种各样的效果和提升，\n但同时装备两个相同的饰品时，\n只有前面那个会生效。
elderenchants=附魔
elderenchantstip=绝大多数的武器和饰品都可以通过附魔来获得提升，\n你可以花大量的钱找一位友善的法师来附魔。\n好的附魔会帮你克服困难与挑战。
elderpotions=药水
elderpotionstip=药水可以在箱子里找到，或是在炼金工作台制造。\n它们对生存和与强敌作战时十分重要，所以不要吝啬使用药水！
eldersettlements=营地
eldersettlementstip=营地是玩家创造的村庄。\n要创造它，首先你需要放置一个营地旗帜。\n准备好对应的房间和建筑后，人们就会陆续入驻。\n使用营地旗帜的锁定功能，可以指定特定房间的入住人类型。\n击败BOSS与推进进度都可以解锁更多职业的人。
demoniccrafting=恶魔科技
tpislandrange=岛屿范围：<range>
tpdestinations=目的地
traderwantbuy=我想买些东西
traderwantsell=我想卖些东西
settlermood=你感觉怎么样？
settlerjoinme=你会加入我的营地吗？
settlerjoinparty=加入我的冒险团队
settlerjoinpartynothappy=我不想加入因为我不开心
settlerleaveparty=离开我的冒险团队
settlerreturntosettlement=立刻返回营地
settlergoodbye=再见
settlerrecruitcost=给我 <cost> ，我就加入你的营地
settlerrecruitfree=我很高兴能加入你的营地！
settlerrecruitnotfound=找不到定居者
settlerrecruitnotpay=负担不起
settlerrecruitnoperm=你没有招收这个定居者的权限
settlernorecruit=我现在想呆在这里
settlerwhatcanyoudo=你能做什么工作?
settlericando=我可以为你的营地做这些工作 <list>
settlericanadventure=而且我可以加入你的冒险团队
settlercarryitems=我拿着这些物品
settlerreceiveitems=接收
settlerchangeequipment=让我们看看你的装备
settlershowmodifiers=显示编辑器
settlercantuseitem=定居者不知道如何使用这个物品
settlerselfmanagequipment=定居者自动管理装备
settlerfilterequipment=过滤允许使用的装备
settlerpreferarmorsets=倾向于使用完整的防具套装
settlerchangework=让我康康你是怎么工作的
settlerchangewhat=你想改变一下吗？
settlersetworkpriority=我想改变你的工作优先级
settlersetdiet=我想改变你的饮食
traderbuy=购买
tradersell=出售
magehelpme=帮我把这些链条弄下来！
magewantenchant=我正想给一个物品附魔
mageenchant=附魔
mageconfirm=附魔！
mageenchanttip=将物品放进来，按下附魔，就能得到随机的附魔或诅咒！
mageenchantbiastip=更高的幸福度会增加附魔的概率
magecost=花费：
pirategiveup=行吧，你击败我了。现在把我从这弄出去！
stylisthelpme=帮我把这些链条弄下来！
stylistwantchange=我想改变一下风格
stylistchange=改变外观
stylistbuy=购买
stylistcost=花费：
stylistshirtcolor=衬衫颜色
stylistshoescolor=鞋子颜色
stylistreset=重置
stylistrandom=随机
brokernotimpressed=抱歉，我不是很喜欢这个营地
brokerwantpawn=我想典当一些东西
brokerprofit=利润：
brokervalue=价格：<value>
explorerfindisland=寻找岛屿
explorerexpeditions=远征
explorerselectisland=选择岛屿
explorerfindcost=我会去找一个 <biome>群系的岛屿，你得给我 <cost> 金币
explorerfoundisland=我在 <dir> 找到了一个 <biome> 群系的岛屿
explorerfoundfail=我找不着你想要的岛屿’
explorerknowalready=看起来，你好像知道我之前找到的那个 <biome> 岛屿了， 要我再去找个新的吗？
explorerfindnew=找个新的
explorerdiscover=在你的 <dir> 找到了岛屿 (<coord>)
explorerselectexp=选择远征地点
explorershowmore=展示更多远征地点
explorerexpcost=我将从 <expedition> 远征中带回物品，需要 <cost> 金币，成功率为<chance>%
explorerexpfail=抱歉，但是我确实无法完成远征
explorerexpcomplete=我在远征中找到了这些物品
minerexpeditions=我想派你去挖矿
minerselectexp=你想让我挖哪种矿石？
minershowmore=展示更多矿石
minerexpcost=给我 <cost> 金币，我会挖很多的 <expedition>
minerexpcomplete=看看我发现了这么多矿石！
settlermissionfailed=抱歉，我实在无法完成任务
settlerreturning=§7<settler> 正在返回 <settlement>
settlerreturned=§7<settler> 回到了 <settlement>
anglerfishingtrips=我想让你来一场垂钓旅行
anglerselecttrip=你在找什么样的鱼？
anglertripcost=给我 <cost> 金币，我给你弄些 <expedition>
anglershowmore=展示更多的旅行
anglertripcomplete=我旅游带回来这些东西
alchemstwantfirework=我想买一些烟花
alchemistfirework=烟花商店
alchemistfireworkcost=消费： 1x<firework> 需要 <cost>x[item=coin]
fireworkcustomshape=自定义形状
fireworkcustomcolor=自定义颜色
fireworkcustomcrackle=自定义响声
fireworkshape=形状：
fireworkcolor=颜色
fireworkcrackle=响声：
enchantscrollequipment=放入一件装备进行注魔！
enchantscrollmelee=放入一件近战武器进行注魔！
enchantscrollranged=放入一件远程武器进行注魔！
enchantscrollmagic=放入一件魔法武器进行注魔！
enchantscrollsummon=放入一件召唤武器进行注魔！
enchantscrolltool=放入一件工具进行注魔！
enchantingscrollwrongtype=<item> 不能被 <enchantment> 注魔
wireinputs=输入
wireoutputs=输出
wire0=红色导线
wire1=绿色导线
wire2=蓝色导线
wire3=黄色导线
SAME_TRANSLATION:bufferticks=Ticks
SAME_TRANSLATION:buffertip=每秒有 <ticks> Ticks
SAME_TRANSLATION:timerticks=Ticks
SAME_TRANSLATION:timertip=每秒有 <ticks> Ticks
soundsemitone=半音
sensorlabel=传感器
sensorplayers=玩家
sensorhostile=敌对生物
sensorpassive=被动生物
sensorrange=范围
rsactivate=激活
rsreset=重置
counterinc=增加
counterdec=减少
countermax=最大值
presentmessage=礼物留言：
wrapconfirm=包装礼物！
slotactions=物品操作
slottransfer=转移物品
slotsplit=拆分物品
slotuse=使用物品
slotlock=锁定物品
slotunlock=解锁物品
slottrash=丢弃物品
slottakeone=拿取一个物品
slotdrop=掉落物品
inventoryquickstack=快速储存
inventoryquickstackinfo=将物品转移到储存中，按 <key> 可以锁定物品防止被转移
inventoryrestock=从储存中快速补充
inventorylootall=全部拿走
inventorytransferall=物品栏中所有物品转移到储存中
inventorytransferallinfo=将所有物品移至附近的库存中。使用 <key> 以锁定不想转移的物品。
inventorysort=对储存进行排序
settlementnone=找不到营地旗帜
settlementman=营地管理
settlementowner=所有者：<owner>
settlementsettings=设置
settmentchangename=改变名字
settlementispriv=营地私有
settlementowneronly=仅限所有者
settlementmakepriv=设为私有
settlementmakepub=设为公开
settlementprivatetip=只有队伍成员才能与私有营地互动
settlementclaim=宣称营地所有权
settlementunclaim=放弃营地所有权
settlementclaimfirst=需要宣称
settlementsettlers=定居者
settlementoutsidesettlers=+<count> 不在营地中
settlementlockbed=锁定定居者床位
settlementselect=选择营地
settlementselecthelp=没有找到营地\n自己建立一个营地，或者加入一个有营地的队伍
settlementnoperm=没有营地的权限
settlementnotfound=找不到营地
settlementmaxsettlers=此营地已达到服务器规定的 <max> 名定居者的上限
settlementfull=<settlement> 没有更多的房间了
settlementjoined=§7<settler> 加入了 <settlement>
settlerchangename=更改营地名称
settlers=定居者
settlersnosettlers=你没有定居者
settlershelpbutton=点击查看定居者列表
settlersavename=保存营地名称
settlerassignbed=为定居者指定床位
settlerhasnobed=没有指定床位
settlmentnotbed=必须是一张床
settlermovesettlement=将定居者移动到另一营地
settlerbanish=放逐定居者
settlerbanishconfirm=你确定要放逐 <settler> 吗？
settlementcommand=指令
settlementcommandtip=通过点击或拖拽来选中定居者
settlementcommandall=选中所有定居者
settlementcommandclearall=清除所有指令
settlementcommandselect=选择定居者
settlementcommandselected=已选中 <count> 位定居者
settlementcommandhidelowhealth=低生命值时躲藏
settlementcommandfollow=跟着我
settlementcommandclear=清除指令
settlementcommandguard=守卫这里
settlementselectsettler=选择一个定居者
settlementnewsettlers=新定居者
settlementallsettlers=所有定居者
settlementequipment=装备
settlementrestrict=活动限制区
settlementrestricthelp=定居者们只能在其限制区域内工作、战斗和游荡。\n如果他们找不到区域，那么将会回到自己的房间。
settlementunrestricted=不受限
settlementunknownarea=未知区域
settlementmanageareas=区域管理
settlementareainvert=互换区域
settlementareadeleteconfirm=是否确定要删除<zone>？
settlementareanew=创建新区域
settlementareadefname=区域 <number>
settlementdiets=饮食
settlementchangediet=改变饮食
settlementnoeatingsettlers=你没有正在吃东西的定居者
settlementdefendzone=防御区
settlementdefendzonehelp=定居者只会攻击在其射程内、防御区内或房间内的敌人。
settlementautoexpand=自动扩大房间周围的防御区域
settlementassignwork=分配工作区域
settlementaddstorage=给营地仓储增加库存
settlementnotinventory=必须是一个库存
settlementalreadyinventory=已经被指定为营地仓储
settlementcannotinventory=不能被指定为营地仓储
settlementassignstorage=分配仓储
settlementstoragetip=定居者将会从营地仓储存取
settlementremovestorage=移除仓储
settlementconfigurestorage=配置仓储
settlementaddworkstation=给营地增加工作站
settlementassignworkstation=分配工作站
settlementworkstationtip=定居者将会使用工作站来制造
settlementremoveworkstation=移除工作站
settlementconfigureworkstation=配置工作站
settlementcannotworkstation=不能被指定为工作站
settlementalreadyworkstation=已经被指定为工作站
settlementcreatezone=创建区域
settlementexpandzone=扩展区域
settlementcreateorexpandzone=创建/扩展区域
settlementshrinkzone=缩小区域
settlementdeletezone=删除区域
settlementconfigurezone=配置 <name>
settlementassignforestry=分配林业区域
settlementforestrytip=定居者将会在林业区域内砍树种树
settlementforestryzone=林业区域
settlementforestryzonedefname=林业区域 <number>
forestryzoneallowchopping=允许砍伐树木
forestryzonereplant=重新种植砍伐的树木
forestryzoneplantcustom=或者只种植树苗：
settlementassignhusbandry=分配畜牧业区域
settlementhusbandrytip=饲养员将会在畜牧业区域挤奶剪毛
settlementhusbandryzone=畜牧区域
settlementhusbandryzonedefname=畜牧区域 <number>
maxanimalsbeforeslaughter=当动物数量达到时宰杀：
settlementassignfertilize=指定施肥区
settlementfertilizetip=农民将在施肥区给农作物施肥
settlementfertilizezone=施肥区
settlementfertilizezonedefname=施肥区域 <number>
settlementworkpriorities=工作优先级
settlementnoworkingsettlers=你没有正在工作的定居者
prioritytop=最高优先
priorityhigher=较高优先
priorityhigh=高优先
prioritynormal=普通优先
prioritylow=低优先
prioritylower=较低优先
prioritylast=最低优先
prioritydisabled=禁止
storagelimittotal=最大物品总数:
storagelimittotalstacks=最大堆叠数:
storagelimitperitem=每个物品的数量上限:
storagelimitperitemstacks=每个物品的最大堆叠数:
storagelimit=储存数量
storagelimitstacks=最大堆叠数
setstoragelimit=设置物品数量上限
clearstoragelimit=清除物品数量上限
storagelimitprefix= <item> 数量上限为 <count>
workstationaddrecipe=增加配方
recipechangename=更改配方名称
recipesavename=保存配方名称
recipeconfigureingredients=配置所允许的材料
recipedocount=重复 <count> 次
recipedountil=重复，直到 <count> 
recipedoforever=一直重复
travelselect=选择岛屿
travelworldmap=世界地图
travelhelp=左键旅行\n右键聚焦
travelteam=队伍成员：
travelworldspawn=§a世界出生点岛屿
travelselfspawn=§a你的出生岛屿
travelserverborder=§6超出服务器世界边界
travelinvaliddestination=§6所选目的地无效
traveldiscovered=§7发现
travelnotdiscovered=§9未发现
travelvisited=§7已访问
travelnotvisited=§9未访问
travelloadingisland=§9加载岛屿...
traveloutrange=§6不在旅行范围内
travelsetnotes=设置笔记
travelnotes=注意：
travelcantcurrent=无法旅行至当前地点
travelcantrange=目的地不在旅行范围内
travelcantmap=前往地图边缘以旅行
travelcancel=取消
travelconfirm=旅行
travelcoords=坐标:
travelcoordself=相对于你自己
travelcoordselfspawn=相对于你的重生点
travelcoordworldspawn=相对于世界出生点
travelcoordglobal=国际坐标
clearrecentdeaths=清除最近的死亡人数
composting=堆肥转化中...
needcompost=需要堆肥材料
producinghoney=生产蜂蜜中...
missingqueen=缺少蜂后
beesempty=没有蜜蜂
beesfewbees=有少量的蜜蜂
beesunderhalf=有不到一半的蜜蜂
beesoverhalf=有超过一半的蜜蜂
beesalmostfull=几乎满是蜜蜂
beesfull=完全充满了蜜蜂
insertvinyl=放入黑胶唱片:
insertplaylist=添加唱片以创建播放列表
musicplaying=<name> 正在播放
cartographeradded=你在桌子上添加了新的地区！
cartographerdiscovered=你发现了新的地区！
cartographernothing=没有新地区可以写入或读取
emptywaystones=空路径石碑槽位: <count>
waystoneempty=空槽位
waystonenum=路径石碑 <num>
waystonehelp=每完成一个系列任务就能获得一个路径石碑槽位\n可以从营地法师处购买路径石碑
placegatewaytablet=放置一个传送门牌来激活
selectincursion=选择入侵
incursionrefreshesin=在 <time> 秒内刷新
noincursionselected=没有选择入侵
incursionused=已经使用
incursioncost=开启花费：
incursionnocost=无费用
incursionobjective=目标：
incursionextractionobjective=开采 <ore>
incursionhuntobjective=追捕敌人
incursionloot=战利品：
incursionmodifiers=地区修饰器：
incursionnomodifiers=无修饰器
incursionopenbutton=开启传送门
incursioncurrent=当前入侵
incursioncompletebutton=完成入侵
incursionnowcomplete=§7入侵已完成
incursionnowclose=§7入侵已关闭
incursionenterbutton=开始入侵
incursionclosebutton=关闭传送门
incursionconfirmcomplete=要完成入侵吗？
incursionconfirmclose=要关闭入侵吗？
incursionconfirmdelete=入侵地区内的物品会永久消失，你也无法再次开启该入侵
incursionprogressbar=<percent> 进度
placeupgradableitem=在槽位放置可升级物品来激活
itemnotupgradable=物品无法升级

// Sidebars
tutoriallabel=教程
wireedit=导线编辑

// Quickbar
shiftmoreinfo=按住SHIFT查看详情
restocktip=从附近库存补充
quickstacktip=储存到附近库存
quickstacktipinfo=将物品快速储存到附近库存，按 <key> 可以锁定物品防止被转移
sorttip=整理库存
sorttipinfo=按 <key> 来锁定物品，防止整理

[quests]
complete=已完成
incomplete=未完成
track=追踪任务
actions=动作
share=分享
shareteamneeded=加入队伍来分享任务
shareresultsingle=与 <count> 人分享 <quest>
shareresultplural=与 <count> 人分享 <quest>
abandon=放弃
abandonconfirm=放弃任务？
genericquest=任务
settlementquest=营地任务
killmob=击败 <mob>
deliveritem=交付 <item>
evilsprotectortip=在夜晚使用神秘传送门召唤
queenspidertip=通过摧毁或使用皇家蛋在冰雪洞穴中召唤
voidwizardtip=在地牢的地下二层战斗
swampguardiantip=使用尖刺化石在沼泽洞穴中召唤
ancientvulturetip=通过摧毁或使用古代雕像在沙漠洞穴中召唤
piratecaptaintip=在海盗村岛屿上发现
reapertip=使用暗影之门在深层洞穴中召唤
cryoqueentip=使用冰皇冠在深雪洞穴中召唤
pestwardentip=使用腐烂之叶在深沼泽洞穴中召唤
sageandgrittip=在沙漠深层洞穴中在圣殿基座上使用龙魂召唤
fallenwizardtip=在沙漠深层洞穴的地下二层的圣殿战斗

[tutorials]
treestorch=按照箭头的指引，学习如何砍倒一棵树，并制作火把
hittree=靠近，拿着斧头按 <key> 键砍树
findtree=找一棵树，把它砍倒
openinv=按 <key> 打开背包
crafttorch=在制造列表内制作火把
craftwork=找一个工作站，或者用10个[item=pinelog]制造一个工作站，然后按 <key1> 放置它。按 <key2> 就可以使用工作站。
craftpick=用5个[item=pinelog]在工作站中制作一把木镐
talkelder=和长者对话来了解这个游戏
elderwalk=靠近长者，按 <key> 与他对话
talkelderstop=走到一边，或者按 <key> 来结束对话
findore=去地下找点矿石，你可以放火把来照亮一片区域
gounder=去洞穴，找矿石
craftladder=在背包中制造一个梯子，用它来前往洞穴
craftladderfloat=在背包中制造一个梯子，按 <key>来放置它
useladder=使用梯子前往洞穴
useladderfloat=靠近，对梯子按 <key> 前往洞穴
mineore=手持镐，按 <key> 挖掘矿石
findorefloat=四处走走，挖些矿石
ores=矿石可以用在制作锭，锭可以用来制作很多东西
travel=如果你到达了地图的边缘，你就可以前往其他岛屿。不同的岛屿有不同的群系，比如地牢和村庄。按 <key> 可以查看世界地图。祝您游戏愉快！
settlement=回到地面放置营地旗帜来新建营地。你可以在初始房屋里的箱子中找到一个旗帜，或者也可以在工作台制作。与旗帜互动，或是按下 <key> 来开启营地菜单。
takeflag=从箱子中取出营地旗帜
useflag=按 <key> 放置营地旗帜
tutorialdone=感谢游玩，祝您探索愉快！
endtutorial=结束教程
next=下一步
skip=跳过

[settingsui]
front=设置
world=世界
general=基础
language=语言
controls=控制
interface=界面
graphics=图形
saveconfirm=保存设置?
displaymode=显示模式：
displaywindowed=窗口化
displayborderless=无边框窗口化
displayfullscreen=全屏
displayres=游戏分辨率：
monitor=控制器：
maxfps=FPS限制：
fpsnocap=无限制
reduceuiframerate=降低UI帧率
particles=粒子效果：
particlesmin=最低
particlesdec=较低
particlesmax=最高
colormode=颜色模式:
colornormal=普通
colorvibrant=鲜艳
lightmode=光照模式：
lightscolor=颜色
lightswhite=白
cursorcolor=光标颜色
sound=音频
confirm=保存修改？
zoomlevel=缩放级别
dynamiczoomlevel=动态缩放级别
limitcamera=将视野限制在地图边界
pausefocus=窗口失去焦点后暂停游戏
skiptutorial=总是跳过教程
showsettlerheadarmor=显示定居者的头部防具
pixelfont=像素字体
showdebug=显示DEBUG信息
showquest=显示任务标志
showteammates=显示队友标记
showpickup=显示拾取文本
showdamage=显示伤害文本
showdot=显示短时总计伤害文本
showmobhealthbars=显示怪物命条
showbosshealthbars=显示BOSS血条
showitemtooltipsbackground=显示物品提示背景
showbasictooltipsbackground=显示基本提示背景
bigtooltiptext=提示使用大字体
showingredientsavailable=在食谱中显示可用的配料
showcontroltips=显示控制说明
showlogicgate=显示逻辑门说明
alwaysshowquickbar=总是显示快速工具栏
interfacesize=尺寸
dynamicinterfacesize=动态界面大小
interfacestyle=界面风格
legacyui=传统
primalui=朴素
ghostui=幽灵
languageselect=语言： <language>
opensaves=打开存档文件夹
resetcache=清空客户端缓存
cacheconfirm=你确定要清空客户端缓存吗？
onlyinmenu=无法在游戏内执行
vsync=启用垂直同步
smoothlight=平滑光照
perffocus=窗口在后台时节省性能
wavygrass=草丛随风飘动
densegrass=稠密草丛
camerashake=镜头晃动
cursorsize=尺寸
mutefocus=窗口失去焦点后静音
outputdevice=输出设备：
outputdevicenone=未找到设备
outputdevicedefault=默认
mastervolume=主音量
effectsvolume=效果音量
weathervolume=天气音量
uivolume=UI音量
musicvolume=音乐音量
nopermission=无服务器权限
communitytranslations=社区翻译
translationcoverage=已完成 <percent> 
helptranslate=为 Necesse 的翻译做贡献

[stats]
filter=过滤器：
time_played=游戏时长
distance_ran=奔跑距离
distance_ridden=骑行距离
damage_dealt=造成的伤害
show_types=显示具体类型
damage_taken=受到的伤害
deaths=死亡次数
mob_kills=生物击杀
boss_kills=BOSS击杀
show_mobs=显示具体生物
island_travels=去过的岛屿
islands_discovered=发现的岛屿
biomes_discovered=发现的群落
show_biomes=显示具体群落
objects_mined=挖掘的物体
objects_placed=放置的物体
tiles_mined=挖掘的地面(地板)
tiles_placed=放置的地面(地板)
food_consumed=消耗的食物
show_food=显示具体食物
potions_consumed=消耗的药水
show_potions=显示具体药水
fish_caught=捉到的鱼
quests_completed=完成的任务
money_earned=赚到的钱
items_sold=卖出的物品
money_spent=花掉的钱
items_bought=买来的物品
items_enchanted=附魔的次数
items_obtained=得到的独特物品
show_item_list=显示物品列表
show_items_all=全部
show_items_obtained=已获得
show_items_not_obtained=未获得
have_all_items=你已经获得了所有物品！
trinkets_worn=穿戴的饰品
show_missing_trinkets=显示未发现的饰品
missing_trinkets=未发现的饰品：
have_all_trinkets=你已经获得了所有饰品！
set_bonuses_worn=使用过的套装奖励
ladders_used=使用过的梯子
doors_used=使用过的门
plates_triggered=踩过的压力板
levers_flicked=使用过的拉杆
homestones_used=使用过的传送石碑
waystones_used=使用过的路径石碑
crafted_items=制作的物品
crates_broken=打碎的罐子
opened_incursions=开启过的入侵
completed_incursions=完成的入侵

normal_damage=普通伤害
true_damage=真实伤害
melee_damage=近战伤害
ranged_damage=远程伤害
magic_damage=魔法伤害
summon_damage=召唤伤害

[controls]
groupgeneral=基础
groupmovement=移动
grouphotbar=快捷键
groupmisc=杂项
groupkeymods=更改绑定按键
groupdebug=DEBUG
mouse1=攻击/放置
mouse2=互动
moveup=向上移动
moveleft=向左移动
movedown=向下移动
moveright=向右移动
movetomouse=移动到光标位置
inventory=打开物品栏
healthpotion=使用生命药水
manapotion=使用魔法药水
eatfood=吃食物
usemount=使用坐骑
setability=使用护甲主动技能
trinketability=使用饰品主动技能
openadventureparty=开启冒险队
opensettlement=开启营地
smartmining=切换智能挖掘
lootall=全部拿走
sortinventory=对物品栏进行排序
quickstack=快速储存
pipette=拾取器
pipettetip=将鼠标悬停在物品或地面上，然后单击此快捷键将其拾取
scoreboard=得分板
showmap=显示岛屿地图
showworldmap=显示世界地图
zoomin=放大
zoomout=缩小
hideui=隐藏UI
screenshot=截图
debuginfo=DEBUG信息
debughud=DEBUG HUD
buffpotions=使用Buff药水
placetorch=放置火把
nexthotbar=下一个快捷栏位
prevhotbar=上一个快捷栏位
hotbarslot=快捷键槽位 <number>
invlock=切换槽位锁定
invquickmove=快速移动
invtrash=快速放进垃圾桶
craftall=制作全部

// Control tips
interacttip=互动
usetip=使用
opentip=打开
closetip=关闭
activatetip=启动
edittip=更改
removetip=移除
cleartip=清除
harvesttip=收获
inspecttip=调查
talktip=交谈
mounttip=坐上
zoomtip=放大/缩小
addroptip=增加绳子
removeropetip=移除绳子
feedtip=喂养
sheartip=修剪
milktip=挤奶
cartographertip=更新地图
equiptip=装备
torchplacetip=按 [input=placetorch] 快速放置
navigatetip=浏览
movetip=移动
aimtip=目标
hotbartip=浏览快捷栏
spacebartip=空格键
backspacetip=删除键
capitalizetip=大写
crafttohand=手工制作
crafttoinventory=背包制作

[misc]
recipecostmult=制作 <amount> 的花费：
recipecostsing=花费：
ingredientmusthave=需要： <ingredient>
blockingexit=§a出口被挡住了，尝试去其他的地方
recentdeath=最近死亡位置
bosssummon=§b<name> 被召唤了！
bossawoke=§b<name> 醒来了！
bossdefeat=§b<name> 被击败了！
bossapproaching=§b一个敌人正在接近...
epescape=§b天亮了，恶魔守卫溜走了！
bossmissingitem=§a缺少激活物品
staircaseopening=§i隐藏的楼梯正在打开...
cannotsummonhere=§a无法在这里召唤
cannotsummoncomplete=§a入侵已经完成
cannotsummonnow=§a现在无法召唤
settlerhungrywarning1=§b如果 <settler> 饥饿时间太长，他们将离开 <settlement>
settlerhungrywarning2=§b<settler> 即将因为饥饿离开 <settlement>
settlerhungryleft=§9<settler> 因饥饿离开了 <settlement>
humanraidapproaching=§b掠袭者正从 <direction> 靠近 <settlement>！
humanraidpreparing=§b掠袭者正在 <settlement> 做准备!
humanraidattacking=§b掠夺者正在攻击 <settlement>!
humanraiddefeated=§a掠夺者已被击败!
humanraidended=§a掠袭者正在离开！
pvpenable=<player> 开启了 PvP
pvpdisable=<player> 禁用了 PvP
teamjoin=<player> 加入了 <team>
teamleft=<player> 离开了 <team>
teamkick=<player> 被踢出了 <team>
teaminvite=你被邀请加入 <team>
teamrequest=<name> 请求加入你的队伍
questinvite=<player> 正在与你分享 <quest>
questnolongervalid=任务不再有效
teamcooptip=§b提示：在玩合作游戏时，记得创建一个队伍并邀请你的朋友！
cannotdroplocked=不能丢弃锁定的物品
screenshotsave=截图已保存到 <path>
mapshotsave=地图已保存到 <path>
mapshottip=正在保存地图，这可能需要一段时间...
shotopen=点击打开文件夹
shotexplore=点击在浏览器打开
movesettler=移动 <settler>
nosettler=不进行NPC锁定
playerconnecting=<player> 正在连接！
playerjoined=<player> 加入了游戏！
motd=§7今日讯息:
laddernotsurface=我只能在地表使用它
mountnotown=你不是这个坐骑的主人！
bedinuse=床已在使用中
sleepprevented=你现在无法入睡
spawndungeon=不能在地牢内设置重生点
spawnincursion=不能在入侵时设置重生点
spawnhouse=不能在野外设置重生点
spawnset=重生点已设置！
spawnremoved=重生点已移除！
spawninvalid=上一个重生点无效
boatplacetip=若想再次捡起小船，用武器击中它！
hungrythought=我饿了
starvingthought=我饿死了
dpscount=每秒伤害：<dps>
permuser=用户
permmod=主持人
permadmin=管理员
permowner=所有者
permserver=服务器
permchange=权限组被设置为： <perm>
allowcheats=允许作弊
smartminingon=智能挖掘：开启
smartminingoff=智能挖掘：关闭
cannotusemounthere=不能在此处使用 <mount>
multisettlementstip=§9注意：拥有许多营地可能会导致性能出现问题
maxsettlementsreached=§6每个玩家的营地上限： <count>
joindiscord=加入官方Discord服务器
followsteamnews=关注 Steam 新闻
followtwitter=关注 Twitter
subscribeyoutube=在Youtube上订阅
animaltame=驯养
animaltameness=驯养进度：<percent>%
animalwild=野生
animalhungry=饥饿
openurl=打开链接： <url>
eanotice=这是一个早期测试版本。\n\n您可能会遇到各种bug、文件丢失、不完整或是未经过调整的功能。\n\n感谢您的游玩！
steamfailed=无法初始化Steam\n确保Steam正在运行
openglfailed=您的系统似乎不支持OpenGL。\n您可以尝试更新您的图形驱动程序，或使用其他系统。
outofmemory=看起来您的系统内存不够了:(尝试关闭一些正在运行的程序，或重新启动计算机。如果问题仍然发生，检查您是否满足最低要求。
datacorrupted=游戏数据文件似乎已损坏：（\n\n请尝试验证Steam中的游戏文件。\n如果问题仍然存在，请在官方Discord或Steam讨论板上报告。
savefailed1=尝试保存世界失败：
savefailed2=为确保游戏保存成功，请尝试退出并重新加载世界。
savecompressfailed=这通常是由防病毒软件阻止压缩存档引起的。\n\n您想在以后保存为未压缩的文件吗？
saveiscompressed=此存档已被压缩，可能无法正常保存。
createworldfailed=创建世界时出错
loadworldfailed=加载世界时出错
backupworldfailed=备份世界失败
renamefailed=无法重命名存档
savenotclosed=之前没有正确保存此世界。这通常是由其他进程（例如杀毒软件）造成的。\n重新启动可能会解决此问题。
restorebackup=游戏会定时创建备份，你可以在世界加载菜单中还原它们
statssaveeerror=存档文件夹创建失败，进度可能不会被保存
workinprogress=正在制作中
workinprogresstip=将在未来的更新中出现
justupdated=刚刚更新！